,G,A,C,T,sum
0,28,32,31,33,124
1,40,39,26,19,124
2,37,29,28,30,124
3,27,28,43,37,135
4,32,29,26,32,119
5,26,32,30,37,125
6,38,30,35,32,135
7,45,20,37,32,134
8,27,31,38,37,133
9,36,25,30,28,119
10,33,29,37,38,137
11,22,30,25,32,109
12,31,22,27,28,108
13,18,31,26,38,113
14,38,30,22,50,140
15,37,28,33,27,125
16,33,33,35,45,146
17,23,27,23,40,113
18,28,29,24,35,116
19,27,31,31,40,129
20,35,42,33,30,140
21,35,37,30,21,123
22,30,24,27,27,108
23,30,22,15,25,92
24,19,34,34,33,120
25,32,31,28,29,120
26,29,39,38,30,136
27,24,35,30,38,127
28,25,32,30,41,128
29,32,31,28,40,131
30,31,25,27,30,113
31,26,39,36,36,137
32,36,38,25,34,133
33,31,33,29,25,118
34,29,26,41,35,131
35,24,23,24,18,89
36,35,26,31,33,125
37,29,26,40,35,130
38,23,32,26,27,108
39,31,29,28,33,121
40,25,33,33,32,123
41,34,32,25,30,121
42,27,27,37,26,117
43,29,23,32,27,111
44,36,24,24,38,122
45,35,27,31,27,120
46,25,31,39,29,124
47,30,35,16,18,99
48,28,32,29,28,117
49,39,34,35,31,139
50,28,27,40,36,131
51,18,33,23,38,112
52,27,26,34,25,112
53,28,38,29,32,127
54,37,24,32,29,122
55,31,24,31,25,111
56,32,25,34,26,117
57,33,45,30,21,129
58,36,32,34,38,140
59,31,26,23,35,115
60,35,34,38,25,132
61,45,35,28,30,138
62,25,35,27,26,113
63,38,32,35,32,137
64,39,34,34,30,137
65,32,45,25,38,140
66,34,24,26,37,121
67,24,23,34,33,114
68,40,27,43,25,135
69,31,26,32,29,118
70,34,35,32,34,135
71,34,27,31,26,118
72,28,26,31,30,115
73,33,35,32,28,128
74,32,30,30,33,125
75,35,35,37,36,143
76,32,35,29,34,130
77,36,32,37,25,130
78,25,36,21,27,109
79,28,32,26,38,124
80,22,37,31,36,126
81,27,36,26,27,116
82,34,23,33,38,128
83,29,25,36,32,122
84,30,34,41,31,136
85,38,32,38,35,143
86,30,28,29,23,110
87,25,27,44,33,129
88,35,29,33,29,126
89,29,32,33,25,119
90,23,54,49,29,155
91,27,26,33,28,114
92,21,36,26,31,114
93,30,23,30,29,112
94,27,40,27,24,118
95,31,28,31,31,121
96,31,36,44,41,152
97,28,33,32,32,125
98,38,26,34,27,125
99,27,37,27,41,132
100,35,31,36,33,135
101,28,30,30,30,118
102,30,38,33,33,134
103,40,27,26,27,120
104,25,24,27,32,108
105,37,32,31,20,120
106,31,33,33,35,132
107,29,27,35,23,114
108,22,32,32,40,126
109,29,28,37,31,125
110,34,28,40,30,132
111,28,35,38,39,140
112,35,35,39,36,145
113,21,31,38,24,114
114,31,26,23,23,103
115,32,27,35,34,128
116,29,25,42,36,132
117,37,33,30,29,129
118,33,33,30,36,132
119,24,32,38,24,118
120,36,24,26,37,123
121,31,22,34,32,119
122,30,30,27,26,113
123,27,31,26,37,121
124,38,28,41,38,145
125,38,25,28,31,122
126,28,32,27,26,113
127,21,42,29,29,121
128,27,35,38,32,132
129,30,30,29,35,124
130,26,39,32,36,133
131,26,30,19,33,108
132,30,35,41,30,136
133,28,44,30,34,136
134,32,33,29,32,126
135,24,29,29,22,104
136,21,27,34,47,129
137,29,37,35,26,127
138,37,33,31,26,127
139,30,42,31,30,133
140,25,30,32,23,110
141,29,29,30,37,125
142,31,32,25,36,124
143,18,27,21,31,97
144,37,36,42,36,151
145,29,30,31,30,120
146,40,32,30,37,139
147,33,31,38,24,126
148,30,35,24,34,123
149,27,36,31,30,124
150,18,29,25,39,111
151,25,34,38,26,123
152,30,28,26,28,112
153,29,40,32,30,131
154,42,31,21,39,133
155,36,40,31,39,146
156,22,30,22,30,104
157,34,35,37,31,137
158,22,30,40,28,120
159,33,31,24,39,127
160,43,29,33,29,134
161,33,31,21,22,107
162,26,23,33,33,115
163,22,32,27,34,115
164,33,38,31,21,123
165,34,35,20,36,125
166,34,36,38,42,150
167,33,41,34,18,126
168,36,29,29,32,126
169,35,26,36,22,119
170,30,32,36,43,141
171,35,35,38,23,131
172,33,34,24,37,128
173,25,32,26,33,116
174,32,32,43,22,129
175,19,33,28,26,106
176,34,36,24,25,119
177,31,36,36,38,141
178,38,27,31,35,131
179,29,38,21,25,113
180,25,28,37,32,122
181,33,32,30,40,135
182,31,27,32,34,124
183,33,29,42,27,131
184,28,33,29,32,122
185,38,31,33,35,137
186,27,18,26,32,103
187,30,27,34,33,124
188,21,25,29,52,127
189,34,32,40,25,131
190,30,30,30,26,116
191,23,25,27,31,106
192,33,27,34,37,131
193,38,25,36,27,126
194,25,35,34,40,134
195,26,29,34,37,126
196,33,34,29,38,134
197,37,37,30,29,133
198,33,32,37,28,130
199,35,20,19,41,115
200,30,39,32,35,136
201,30,25,30,24,109
202,23,23,26,37,109
203,28,27,28,36,119
204,33,34,30,32,129
205,35,32,29,25,121
206,31,31,31,30,123
207,28,30,26,39,123
208,28,27,48,25,128
209,31,20,37,42,130
210,33,41,24,44,142
211,23,30,39,33,125
212,33,25,36,39,133
213,40,19,29,24,112
214,36,30,24,29,119
215,26,38,45,23,132
216,28,41,32,25,126
217,27,38,25,29,119
218,29,26,23,30,108
219,36,34,24,37,131
220,35,31,21,32,119
221,21,30,32,23,106
222,35,24,36,19,114
223,20,30,36,40,126
224,34,23,32,33,122
225,33,26,32,28,119
226,39,33,26,32,130
227,34,40,25,38,137
228,25,43,29,34,131
229,39,33,23,22,117
230,34,32,32,24,122
231,22,29,30,26,107
232,31,28,36,32,127
233,34,30,36,26,126
234,42,36,22,30,130
235,34,36,32,32,134
236,27,24,25,39,115
237,42,28,28,32,130
238,30,27,31,28,116
239,23,41,26,24,114
240,37,35,32,32,136
241,28,32,22,32,114
242,31,34,36,36,137
243,28,36,37,30,131
244,32,39,30,34,135
245,27,31,42,30,130
246,31,32,31,29,123
247,36,31,29,32,128
248,25,34,34,26,119
249,28,28,22,31,109
250,31,41,27,33,132
251,37,24,31,33,125
252,33,29,39,21,122
253,37,31,36,25,129
254,29,27,19,32,107
255,20,36,42,37,135
256,25,33,28,38,124
257,33,35,38,39,145
258,46,22,37,29,134
259,28,24,35,36,123
260,24,31,17,38,110
261,33,29,50,25,137
262,27,28,42,24,121
263,32,28,38,25,123
264,31,33,40,24,128
265,33,41,34,24,132
266,33,46,34,31,144
267,44,32,28,31,135
268,32,32,32,26,122
269,32,38,25,33,128
270,23,36,22,31,112
271,28,29,35,49,141
272,27,29,33,24,113
273,28,48,36,28,140
274,32,40,35,31,138
275,30,42,29,39,140
276,34,37,34,33,138
277,32,22,36,33,123
278,25,35,35,28,123
279,37,45,40,30,152
280,31,29,19,31,110
281,32,41,32,22,127
282,27,29,35,26,117
283,24,30,35,38,127
284,28,30,42,33,133
285,26,30,29,37,122
286,43,32,26,29,130
287,29,24,31,35,119
288,25,35,31,28,119
289,34,36,36,40,146
290,36,28,27,32,123
291,31,35,26,26,118
292,26,29,34,26,115
293,29,35,23,37,124
294,29,38,26,28,121
295,27,34,38,31,130
296,26,33,35,27,121
297,37,26,24,29,116
298,32,36,28,28,124
299,27,39,30,28,124
300,28,29,43,31,131
301,20,33,32,36,121
302,32,34,38,28,132
303,43,27,33,33,136
304,28,34,32,31,125
305,31,26,28,34,119
306,22,29,29,36,116
307,38,27,33,29,127
308,31,33,29,39,132
309,24,33,38,30,125
310,35,34,33,23,125
311,30,33,27,35,125
312,32,26,16,38,112
313,27,26,27,24,104
314,29,22,44,31,126
315,25,37,36,37,135
316,34,33,24,35,126
317,28,34,42,32,136
318,33,32,29,26,120
319,34,20,19,35,108
320,28,32,32,25,117
321,29,36,19,21,105
322,27,22,39,31,119
323,42,30,26,34,132
324,29,26,26,34,115
325,27,34,27,32,120
326,37,34,34,34,139
327,30,32,32,30,124
328,31,28,31,36,126
329,36,19,30,24,109
330,32,28,39,32,131
331,39,30,33,36,138
332,34,33,32,34,133
333,32,33,25,28,118
334,39,30,28,38,135
335,26,23,33,26,108
336,31,17,30,23,101
337,28,34,34,24,120
338,17,36,29,30,112
339,47,36,28,28,139
340,34,29,23,29,115
341,24,27,29,24,104
342,24,26,31,33,114
343,27,36,26,34,123
344,25,24,38,34,121
345,27,34,40,32,133
346,33,30,35,26,124
347,28,37,34,29,128
348,34,30,33,24,121
349,29,30,32,42,133
350,31,35,32,35,133
351,24,24,30,32,110
352,32,30,28,40,130
353,30,27,25,34,116
354,26,30,32,25,113
355,29,44,25,35,133
356,31,34,26,20,111
357,23,28,25,19,95
358,29,28,29,34,120
359,29,26,28,32,115
360,33,29,27,30,119
361,27,27,35,40,129
362,34,35,30,27,126
363,32,26,30,39,127
364,28,39,28,28,123
365,33,30,32,34,129
366,34,34,28,35,131
367,37,34,37,27,135
368,32,35,30,34,131
369,34,37,41,39,151
370,39,30,31,32,132
371,32,23,34,34,123
372,40,29,35,25,129
373,33,30,34,27,124
374,34,32,27,35,128
375,37,35,33,18,123
376,40,32,23,35,130
377,32,35,32,37,136
378,23,35,23,28,109
379,27,30,34,25,116
380,36,34,32,24,126
381,23,24,37,24,108
382,40,25,28,22,115
383,30,38,28,33,129
384,27,42,17,29,115
385,44,31,38,40,153
386,33,30,28,40,131
387,37,37,35,30,139
388,28,36,23,29,116
389,26,40,25,41,132
390,42,25,34,30,131
391,31,37,29,25,122
392,38,32,30,30,130
393,25,39,34,23,121
394,29,29,29,34,121
395,23,35,26,34,118
396,31,29,30,27,117
397,31,28,19,35,113
398,27,25,33,36,121
399,29,46,33,22,130
400,27,46,42,26,141
401,37,31,18,24,110
402,36,36,29,38,139
403,33,27,23,37,120
404,32,31,30,26,119
405,35,26,28,23,112
406,28,31,22,42,123
407,36,26,31,30,123
408,49,30,32,32,143
409,36,32,27,28,123
410,34,27,36,30,127
411,29,33,29,28,119
412,24,20,29,33,106
413,35,32,27,32,126
414,33,25,29,46,133
415,35,22,41,33,131
416,25,23,44,37,129
417,28,30,39,35,132
418,44,30,36,37,147
419,35,24,35,30,124
420,22,24,21,22,89
421,36,30,34,21,121
422,35,28,23,40,126
423,37,34,40,45,156
424,20,31,32,25,108
425,33,28,44,33,138
426,34,27,34,26,121
427,27,31,32,23,113
428,30,21,32,37,120
429,39,36,28,34,137
430,26,34,28,38,126
431,30,29,24,33,116
432,30,24,30,40,124
433,33,40,38,32,143
434,31,28,32,36,127
435,37,22,17,27,103
436,38,26,28,34,126
437,27,26,33,30,116
438,28,27,41,28,124
439,31,27,27,23,108
440,35,27,33,27,122
441,32,45,38,33,148
442,33,18,44,33,128
443,29,28,25,25,107
444,27,38,32,34,131
445,28,31,30,36,125
446,26,36,39,31,132
447,37,29,31,33,130
448,26,38,37,26,127
449,28,29,38,25,120
450,34,30,29,32,125
451,33,41,26,30,130
452,41,31,31,29,132
453,28,24,25,35,112
454,21,32,31,33,117
455,37,34,27,23,121
456,26,29,29,30,114
457,35,36,35,26,132
458,28,26,40,31,125
459,30,22,38,23,113
460,25,33,45,26,129
461,36,32,28,45,141
462,33,38,32,34,137
463,36,44,25,34,139
464,32,29,33,32,126
465,21,24,33,37,115
466,20,41,32,30,123
467,35,30,34,32,131
468,39,31,39,22,131
469,26,27,36,35,124
470,33,24,23,38,118
471,27,32,39,29,127
472,30,32,23,29,114
473,27,35,31,29,122
474,39,29,32,27,127
475,26,30,37,31,124
476,26,33,33,34,126
477,28,39,35,32,134
478,27,29,26,32,114
479,28,23,33,38,122
480,37,28,34,31,130
481,39,31,24,30,124
482,27,23,26,43,119
483,33,26,41,30,130
484,29,39,32,40,140
485,32,30,44,28,134
486,25,28,32,33,118
487,35,27,30,25,117
488,26,27,30,31,114
489,38,37,33,36,144
490,27,33,32,26,118
491,30,38,38,26,132
492,32,39,28,30,129
493,26,38,33,31,128
494,36,36,24,39,135
495,24,33,31,40,128
496,32,44,34,32,142
497,31,37,31,34,133
498,31,41,37,24,133
499,32,31,42,34,139
500,39,18,30,20,107
501,25,36,30,32,123
502,32,34,31,31,128
503,32,32,21,40,125
504,44,31,23,34,132
505,27,28,36,29,120
506,26,31,31,21,109
507,26,30,42,43,141
508,36,29,30,28,123
509,33,35,31,32,131
510,34,31,31,31,127
511,34,27,29,35,125
512,25,23,26,29,103
513,37,27,27,35,126
514,28,32,33,36,129
515,29,20,33,22,104
516,32,29,28,28,117
517,32,28,37,31,128
518,28,35,30,29,122
519,30,35,32,34,131
520,26,37,32,35,130
521,23,31,32,32,118
522,37,32,26,39,134
523,33,25,24,34,116
524,40,28,34,26,128
525,29,29,26,33,117
526,30,36,45,30,141
527,32,33,29,27,121
528,29,26,28,34,117
529,29,33,28,31,121
530,30,35,36,26,127
531,35,30,25,37,127
532,19,24,34,33,110
533,33,31,27,36,127
534,30,37,44,33,144
535,29,32,29,38,128
536,21,33,22,36,112
537,28,25,29,28,110
538,36,26,43,20,125
539,37,33,23,27,120
540,24,35,33,23,115
541,25,39,41,33,138
542,27,42,34,27,130
543,32,23,33,26,114
544,43,24,20,32,119
545,28,32,35,40,135
546,34,38,27,29,128
547,24,27,43,27,121
548,32,31,34,26,123
549,25,42,35,30,132
550,40,23,29,34,126
551,39,33,31,27,130
552,28,36,32,30,126
553,28,31,24,37,120
554,27,28,32,29,116
555,29,29,28,37,123
556,24,33,31,32,120
557,26,33,30,30,119
558,39,34,29,32,134
559,33,34,29,43,139
560,43,35,29,23,130
561,36,26,30,27,119
562,38,34,32,18,122
563,29,40,21,39,129
564,31,34,34,21,120
565,32,23,29,26,110
566,30,38,31,37,136
567,29,29,34,36,128
568,31,32,34,26,123
569,29,36,36,22,123
570,39,22,27,34,122
571,29,30,25,31,115
572,38,28,21,30,117
573,29,29,36,40,134
574,32,32,42,24,130
575,30,39,28,29,126
576,35,29,27,25,116
577,29,33,23,38,123
578,41,27,31,32,131
579,20,32,38,38,128
580,28,38,32,22,120
581,25,26,43,24,118
582,36,25,40,26,127
583,31,37,28,23,119
584,30,33,29,31,123
585,22,30,36,36,124
586,28,31,35,32,126
587,29,38,30,37,134
588,29,25,33,30,117
589,30,27,35,28,120
590,26,25,38,40,129
591,41,34,21,33,129
592,31,29,37,32,129
593,26,39,29,30,124
594,32,31,31,36,130
595,38,32,20,30,120
596,32,24,22,36,114
597,33,24,30,37,124
598,28,28,30,42,128
599,32,32,34,33,131
600,32,27,28,27,114
601,34,26,33,35,128
602,19,35,22,26,102
603,32,36,40,42,150
604,30,25,22,44,121
605,41,35,32,24,132
606,34,26,32,33,125
607,38,31,35,23,127
608,34,19,29,37,119
609,27,21,32,30,110
610,22,42,34,29,127
611,45,27,23,24,119
612,32,25,31,25,113
613,34,35,26,33,128
614,33,34,34,26,127
615,28,31,30,45,134
616,29,36,36,35,136
617,40,31,30,27,128
618,32,22,27,26,107
619,30,42,35,25,132
620,32,36,23,30,121
621,32,31,44,27,134
622,33,25,25,23,106
623,31,42,31,30,134
624,31,34,22,17,104
625,37,29,35,28,129
626,31,29,28,25,113
627,25,31,25,39,120
628,34,30,43,32,139
629,34,32,32,27,125
630,27,16,30,39,112
631,36,34,33,31,134
632,22,27,30,33,112
633,27,24,30,34,115
634,27,41,44,34,146
635,27,22,35,40,124
636,32,25,27,30,114
637,38,29,40,28,135
638,24,21,34,34,113
639,32,26,41,38,137
640,41,29,25,39,134
641,39,42,37,36,154
642,36,31,33,31,131
643,36,30,24,30,120
644,29,29,30,31,119
645,29,25,30,36,120
646,25,41,30,37,133
647,27,31,32,32,122
648,25,40,29,34,128
649,25,30,29,28,112
650,26,24,36,33,119
651,30,22,38,26,116
652,35,27,20,30,112
653,26,26,25,32,109
654,23,39,22,31,115
655,31,29,38,24,122
656,32,34,27,35,128
657,27,25,37,35,124
658,34,41,35,30,140
659,29,35,35,20,119
660,30,35,33,30,128
661,21,27,40,29,117
662,29,31,31,30,121
663,26,29,16,33,104
664,28,29,41,33,131
665,26,29,23,26,104
666,33,37,23,27,120
667,29,35,36,29,129
668,45,29,35,33,142
669,27,31,39,44,141
670,26,27,35,32,120
671,35,27,28,34,124
672,31,25,33,31,120
673,32,34,37,24,127
674,26,49,26,38,139
675,24,36,30,35,125
676,26,28,38,33,125
677,28,26,35,28,117
678,36,26,27,32,121
679,34,19,31,24,108
680,27,29,34,34,124
681,27,35,28,31,121
682,41,33,20,27,121
683,31,35,23,27,116
684,33,29,34,24,120
685,32,28,29,36,125
686,42,26,27,35,130
687,29,27,31,32,119
688,37,36,40,32,145
689,34,25,30,32,121
690,17,25,36,31,109
691,40,34,31,21,126
692,27,31,28,20,106
693,34,31,37,30,132
694,29,33,33,33,128
695,29,31,27,37,124
696,33,32,37,26,128
697,38,35,29,27,129
698,36,30,33,29,128
699,34,32,33,39,138
700,38,32,33,32,135
701,25,33,24,25,107
702,26,30,30,25,111
703,29,39,34,31,133
704,23,30,38,22,113
705,38,22,33,27,120
706,26,25,29,31,111
707,30,33,40,27,130
708,25,28,30,32,115
709,27,35,37,29,128
710,38,31,19,30,118
711,30,43,40,30,143
712,33,41,28,36,138
713,29,36,35,35,135
714,41,39,30,35,145
715,30,34,35,31,130
716,39,31,28,33,131
717,45,36,28,30,139
718,38,34,35,26,133
719,31,35,27,33,126
720,29,40,32,39,140
721,30,36,38,32,136
722,36,36,25,31,128
723,35,27,30,31,123
724,27,33,38,27,125
725,32,23,33,29,117
726,38,40,26,33,137
727,25,19,25,29,98
728,49,24,32,28,133
729,29,33,32,25,119
730,24,27,26,30,107
731,31,33,46,27,137
732,28,34,33,35,130
733,38,31,26,37,132
734,36,35,28,41,140
735,44,28,33,34,139
736,22,36,41,34,133
737,27,33,25,29,114
738,35,33,32,34,134
739,31,26,30,28,115
740,44,26,40,29,139
741,39,36,25,39,139
742,37,30,36,26,129
743,31,21,34,33,119
744,22,27,27,41,117
745,35,35,32,28,130
746,34,33,32,31,130
747,32,30,37,37,136
748,25,38,40,30,133
749,34,30,27,35,126
750,27,26,34,26,113
751,26,25,34,42,127
752,26,19,32,31,108
753,41,36,27,25,129
754,32,29,34,27,122
755,32,33,23,27,115
756,36,37,29,29,131
757,31,41,34,30,136
758,27,34,29,34,124
759,32,36,50,24,142
760,36,29,28,41,134
761,24,28,25,25,102
762,28,38,32,26,124
763,26,33,24,22,105
764,29,26,34,31,120
765,19,40,35,30,124
766,33,29,34,30,126
767,29,31,40,31,131
768,25,31,30,33,119
769,32,35,35,30,132
770,25,27,40,25,117
771,31,36,23,31,121
772,19,30,27,36,112
773,23,18,24,30,95
774,31,34,41,33,139
775,33,26,24,28,111
776,31,36,29,39,135
777,44,39,30,24,137
778,30,28,31,33,122
779,29,23,39,21,112
780,36,27,26,35,124
781,27,31,28,34,120
782,33,23,20,31,107
783,32,38,35,25,130
784,28,29,46,26,129
785,34,25,36,23,118
786,35,34,36,39,144
787,28,32,38,26,124
788,27,37,29,22,115
789,31,27,31,31,120
790,37,25,29,46,137
791,33,36,40,24,133
792,31,42,25,24,122
793,29,25,27,38,119
794,27,27,39,23,116
795,29,27,29,36,121
796,28,33,25,30,116
797,33,26,26,30,115
798,19,38,28,27,112
799,31,34,32,35,132
800,26,40,29,26,121
801,46,32,23,34,135
802,37,27,36,41,141
803,24,33,32,37,126
804,46,39,26,22,133
805,37,30,35,31,133
806,31,26,27,35,119
807,35,27,32,29,123
808,36,32,27,38,133
809,28,30,32,26,116
810,43,28,43,26,140
811,37,34,31,26,128
812,26,24,24,28,102
813,20,30,23,34,107
814,35,27,37,22,121
815,30,29,32,26,117
816,40,44,25,27,136
817,28,40,32,31,131
818,35,29,33,28,125
819,33,29,32,32,126
820,36,24,36,26,122
821,21,33,28,33,115
822,21,40,29,23,113
823,34,34,32,41,141
824,30,29,21,32,112
825,27,37,26,39,129
826,27,34,28,29,118
827,35,30,32,31,128
828,30,34,34,28,126
829,32,28,38,43,141
830,25,27,36,32,120
831,30,31,29,35,125
832,38,34,33,33,138
833,29,35,27,33,124
834,32,35,31,33,131
835,29,39,34,38,140
836,34,18,42,32,126
837,40,33,32,22,127
838,35,27,26,27,115
839,28,34,31,33,126
840,36,41,33,34,144
841,35,38,44,41,158
842,28,32,36,36,132
843,30,29,32,32,123
844,30,29,35,34,128
845,29,35,30,29,123
846,28,30,24,34,116
847,30,28,29,25,112
848,32,35,30,34,131
849,27,35,29,32,123
850,34,20,35,28,117
851,39,28,30,37,134
852,33,48,22,39,142
853,32,28,35,34,129
854,39,31,26,46,142
855,42,33,25,31,131
856,29,38,30,31,128
857,37,27,30,25,119
858,30,37,35,37,139
859,37,45,31,23,136
860,33,30,29,26,118
861,26,30,32,32,120
862,35,36,31,32,134
863,28,29,41,27,125
864,29,30,25,34,118
865,41,38,28,25,132
866,31,35,24,41,131
867,23,38,31,39,131
868,19,20,34,32,105
869,24,36,38,24,122
870,27,31,28,32,118
871,32,22,36,27,117
872,23,41,32,25,121
873,29,27,24,30,110
874,31,37,34,27,129
875,39,31,32,37,139
876,38,30,35,34,137
877,32,33,34,30,129
878,26,27,35,38,126
879,30,31,26,25,112
880,39,33,38,30,140
881,22,26,39,32,119
882,39,32,27,40,138
883,35,37,26,39,137
884,19,31,27,39,116
885,36,38,23,32,129
886,38,27,30,29,124
887,33,37,22,37,129
888,32,30,39,31,132
889,22,26,28,28,104
890,35,23,30,37,125
891,37,27,29,29,122
892,25,31,33,30,119
893,31,33,27,27,118
894,26,31,35,28,120
895,37,39,29,25,130
896,34,32,24,39,129
897,37,26,33,44,140
898,43,25,30,32,130
899,34,30,33,29,126
900,32,34,39,22,127
901,31,32,35,36,134
902,30,35,36,31,132
903,23,38,36,31,128
904,30,39,32,23,124
905,34,39,29,35,137
906,35,36,31,25,127
907,34,40,32,31,137
908,23,31,26,32,112
909,29,38,30,28,125
910,29,34,30,41,134
911,27,22,28,30,107
912,25,30,27,28,110
913,36,36,38,24,134
914,31,28,38,33,130
915,31,30,33,32,126
916,34,31,24,35,124
917,29,37,28,38,132
918,42,28,36,38,144
919,23,27,35,28,113
920,30,29,29,34,122
921,25,27,35,29,116
922,33,27,26,30,116
923,37,35,32,29,133
924,23,28,38,31,120
925,37,37,34,40,148
926,34,34,29,26,123
927,45,28,33,37,143
928,33,25,34,26,118
929,31,37,34,29,131
930,29,28,34,28,119
931,27,32,29,35,123
932,26,28,29,21,104
933,30,38,33,36,137
934,34,42,45,30,151
935,27,39,35,27,128
936,31,31,42,32,136
937,21,41,30,32,124
938,23,27,32,19,101
939,29,38,34,27,128
940,30,38,28,31,127
941,30,30,37,26,123
942,31,31,34,33,129
943,29,38,24,42,133
944,30,24,31,20,105
945,39,21,28,41,129
946,29,32,28,28,117
947,31,21,39,33,124
948,31,33,34,21,119
949,27,30,27,31,115
950,29,41,46,37,153
951,27,26,23,29,105
952,31,27,34,33,125
953,47,35,34,23,139
954,26,23,28,26,103
955,31,36,37,35,139
956,27,38,38,27,130
957,18,36,33,31,118
958,24,21,45,29,119
959,35,37,39,30,141
960,42,42,40,37,161
961,45,28,38,40,151
962,35,28,30,27,120
963,32,28,26,22,108
964,29,27,31,36,123
965,44,39,31,31,145
966,39,30,34,29,132
967,32,34,42,15,123
968,31,24,28,30,113
969,31,29,33,31,124
970,28,39,35,30,132
971,25,23,25,32,105
972,29,31,32,35,127
973,28,34,41,30,133
974,29,22,21,31,103
975,27,37,40,34,138
976,24,32,32,27,115
977,37,31,21,30,119
978,30,34,27,38,129
979,23,39,29,21,112
980,34,34,26,31,125
981,38,26,38,29,131
982,31,33,30,32,126
983,33,41,30,34,138
984,34,26,29,28,117
985,28,30,26,31,115
986,26,37,33,30,126
987,38,34,36,26,134
988,20,31,29,34,114
989,30,28,22,18,98
990,39,32,31,34,136
991,37,41,20,30,128
992,34,27,28,32,121
993,25,41,29,34,129
994,31,30,23,26,110
995,37,33,31,38,139
996,29,23,27,27,106
997,28,36,28,32,124
998,37,29,35,30,131
999,30,28,34,33,125
1000,29,41,26,20,116
1001,32,25,31,34,122
1002,33,25,24,39,121
1003,25,30,31,30,116
1004,33,35,37,27,132
1005,37,42,20,33,132
1006,31,30,28,35,124
1007,32,25,33,32,122
1008,38,33,39,30,140
1009,35,23,28,23,109
1010,35,27,27,25,114
1011,24,36,28,31,119
1012,35,29,41,21,126
1013,32,28,33,28,121
1014,34,40,32,27,133
1015,23,36,44,37,140
1016,29,23,32,35,119
1017,33,32,31,30,126
1018,30,30,35,33,128
1019,29,34,29,31,123
1020,27,31,34,28,120
1021,27,30,37,41,135
1022,31,41,36,25,133
1023,41,22,33,41,137
1024,31,37,34,33,135
1025,26,25,26,25,102
1026,34,31,28,30,123
1027,29,28,36,34,127
1028,27,40,33,30,130
1029,35,19,31,16,101
1030,31,11,35,20,97
1031,28,34,38,34,134
1032,35,29,30,28,122
1033,31,21,16,42,110
1034,29,26,50,27,132
1035,18,45,36,41,140
1036,34,30,30,34,128
1037,34,26,30,25,115
1038,40,31,26,31,128
1039,31,27,31,33,122
1040,38,44,24,29,135
1041,35,34,34,28,131
1042,23,29,30,29,111
1043,42,37,28,24,131
1044,23,36,27,34,120
1045,30,18,35,28,111
1046,35,31,24,36,126
1047,26,28,26,28,108
1048,39,44,33,29,145
1049,30,33,29,43,135
1050,28,36,33,29,126
1051,23,31,46,28,128
1052,28,34,32,29,123
1053,26,26,25,21,98
1054,25,31,30,36,122
1055,34,36,31,26,127
1056,26,29,26,39,120
1057,27,26,31,23,107
1058,30,23,27,18,98
1059,32,29,37,33,131
1060,27,37,28,33,125
1061,36,29,36,38,139
1062,30,27,36,25,118
1063,22,25,25,24,96
1064,26,29,23,36,114
1065,30,38,42,40,150
1066,39,40,35,29,143
1067,33,35,27,28,123
1068,40,30,24,34,128
1069,40,34,29,26,129
1070,39,27,21,36,123
1071,46,27,22,33,128
1072,34,31,29,32,126
1073,35,32,34,43,144
1074,27,32,26,29,114
1075,28,24,32,31,115
1076,42,32,27,31,132
1077,23,33,33,29,118
1078,27,25,30,29,111
1079,40,29,35,31,135
1080,31,28,21,27,107
1081,29,25,38,39,131
1082,23,36,19,34,112
1083,26,38,28,30,122
1084,31,31,34,27,123
1085,28,32,29,33,122
1086,36,35,32,32,135
1087,33,27,43,39,142
1088,38,33,27,21,119
1089,32,37,29,26,124
1090,37,34,41,27,139
1091,45,31,36,34,146
1092,28,33,33,28,122
1093,28,37,28,38,131
1094,33,30,26,37,126
1095,27,29,34,27,117
1096,29,28,29,34,120
1097,36,33,26,30,125
1098,34,29,28,31,122
1099,31,28,31,28,118
1100,25,35,27,36,123
1101,31,28,34,37,130
1102,25,35,27,35,122
1103,32,27,25,30,114
1104,35,29,29,28,121
1105,28,39,24,30,121
1106,27,31,42,28,128
1107,26,29,31,40,126
1108,32,27,37,42,138
1109,32,24,36,31,123
1110,30,33,32,26,121
1111,31,39,24,27,121
1112,32,25,32,22,111
1113,32,34,26,31,123
1114,23,28,30,29,110
1115,35,30,37,29,131
1116,31,35,31,24,121
1117,32,20,35,30,117
1118,25,32,43,28,128
1119,33,36,30,35,134
1120,37,25,30,24,116
1121,33,33,27,24,117
1122,40,31,30,32,133
1123,34,27,30,34,125
1124,37,29,30,29,125
1125,30,43,36,43,152
1126,24,36,35,33,128
1127,27,26,39,38,130
1128,40,26,31,30,127
1129,32,26,29,36,123
1130,31,33,42,24,130
1131,32,26,38,30,126
1132,36,26,29,35,126
1133,31,24,37,35,127
1134,22,39,33,31,125
1135,32,33,28,30,123
1136,29,35,33,26,123
1137,29,32,28,28,117
1138,40,37,34,31,142
1139,20,27,36,29,112
1140,34,31,30,26,121
1141,27,32,28,27,114
1142,32,41,37,38,148
1143,24,38,29,21,112
1144,25,29,26,32,112
1145,34,34,27,35,130
1146,22,27,25,30,104
1147,29,32,24,25,110
1148,27,25,27,42,121
1149,30,32,24,38,124
1150,27,21,33,29,110
1151,35,34,24,37,130
1152,26,16,24,33,99
1153,21,34,26,37,118
1154,31,34,35,29,129
1155,31,40,26,43,140
1156,41,34,26,27,128
1157,23,28,25,29,105
1158,29,32,35,25,121
1159,35,36,29,34,134
1160,38,29,33,28,128
1161,31,29,32,23,115
1162,38,19,34,31,122
1163,33,31,30,25,119
1164,38,37,41,29,145
1165,44,28,27,29,128
1166,44,28,28,35,135
1167,30,31,21,39,121
1168,30,32,31,30,123
1169,23,34,34,40,131
1170,34,22,29,37,122
1171,27,45,41,32,145
1172,20,28,28,37,113
1173,32,29,28,40,129
1174,26,26,20,40,112
1175,27,28,35,38,128
1176,29,32,27,32,120
1177,23,36,43,32,134
1178,26,43,31,30,130
1179,29,32,34,30,125
1180,31,35,31,30,127
1181,35,30,27,34,126
1182,32,23,31,32,118
1183,27,31,32,30,120
1184,33,38,31,33,135
1185,22,31,34,37,124
1186,29,28,37,29,123
1187,22,30,36,30,118
1188,32,36,20,29,117
1189,35,23,27,34,119
1190,22,36,30,29,117
1191,27,36,33,25,121
1192,25,31,30,34,120
1193,38,30,40,25,133
1194,36,28,28,31,123
1195,36,24,31,28,119
1196,35,33,36,31,135
1197,31,27,33,29,120
1198,27,23,37,27,114
1199,39,38,29,31,137
1200,27,29,33,30,119
1201,22,32,34,22,110
1202,30,33,27,27,117
1203,42,38,30,36,146
1204,36,37,32,35,140
1205,35,21,26,28,110
1206,28,32,19,30,109
1207,31,30,42,33,136
1208,25,31,23,44,123
1209,31,37,39,34,141
1210,29,36,30,33,128
1211,31,29,42,38,140
1212,27,33,38,24,122
1213,37,36,29,27,129
1214,40,37,35,32,144
1215,39,40,27,31,137
1216,29,33,23,26,111
1217,23,33,27,30,113
1218,32,24,36,32,124
1219,35,34,31,28,128
1220,28,35,25,36,124
1221,35,27,36,33,131
1222,28,23,33,34,118
1223,33,31,35,38,137
1224,26,37,29,36,128
1225,25,30,49,26,130
1226,35,36,33,31,135
1227,27,27,28,33,115
1228,36,24,25,29,114
1229,35,26,31,27,119
1230,41,31,26,26,124
1231,28,29,41,31,129
1232,30,30,41,36,137
1233,34,39,42,38,153
1234,47,31,23,33,134
1235,31,26,27,24,108
1236,29,31,31,27,118
1237,24,38,26,36,124
1238,23,29,35,38,125
1239,29,34,29,26,118
1240,39,21,31,34,125
1241,29,36,28,32,125
1242,38,34,29,25,126
1243,46,26,32,43,147
1244,31,29,42,29,131
1245,37,40,33,21,131
1246,42,38,35,35,150
1247,27,32,37,32,128
1248,41,34,29,28,132
1249,31,33,33,31,128
1250,32,33,31,45,141
1251,31,32,27,34,124
1252,28,36,38,23,125
1253,28,43,30,34,135
1254,34,39,17,30,120
1255,34,38,31,34,137
1256,35,30,33,32,130
1257,36,31,34,24,125
1258,35,27,37,27,126
1259,26,29,30,28,113
1260,28,35,31,32,126
1261,36,27,30,30,123
1262,35,35,22,32,124
1263,27,38,15,27,107
1264,36,27,40,28,131
1265,37,37,35,21,130
1266,21,32,28,38,119
1267,30,30,23,32,115
1268,42,43,40,23,148
1269,23,30,22,35,110
1270,32,35,39,43,149
1271,28,37,29,39,133
1272,34,24,34,32,124
1273,27,31,24,36,118
1274,27,25,29,40,121
1275,29,30,38,26,123
1276,26,28,29,21,104
1277,23,38,29,25,115
1278,22,30,31,31,114
1279,28,22,29,38,117
1280,22,49,34,29,134
1281,27,36,37,25,125
1282,24,27,46,34,131
1283,29,25,24,35,113
1284,26,34,24,45,129
1285,33,29,31,30,123
1286,26,38,23,30,117
1287,24,41,34,29,128
1288,32,37,23,21,113
1289,28,35,31,37,131
1290,27,28,24,27,106
1291,32,28,33,28,121
1292,33,21,23,31,108
1293,33,29,42,27,131
1294,29,35,42,36,142
1295,26,36,23,40,125
1296,37,30,27,30,124
1297,38,31,20,27,116
1298,32,30,28,34,124
1299,34,35,23,19,111
1300,32,29,26,33,120
1301,30,42,26,34,132
1302,28,36,25,38,127
1303,34,39,32,28,133
1304,33,20,31,39,123
1305,33,30,34,25,122
1306,34,42,30,31,137
1307,27,20,36,28,111
1308,26,38,24,43,131
1309,29,36,46,37,148
1310,33,43,31,34,141
1311,26,34,37,31,128
1312,28,30,34,36,128
1313,25,41,39,28,133
1314,39,35,36,41,151
1315,21,28,31,25,105
1316,27,32,31,30,120
1317,36,33,30,27,126
1318,30,30,37,22,119
1319,28,30,35,38,131
1320,36,33,35,29,133
1321,35,25,29,32,121
1322,34,26,31,33,124
1323,27,26,35,30,118
1324,31,25,33,38,127
1325,35,32,34,31,132
1326,25,41,28,30,124
1327,17,33,27,33,110
1328,32,29,23,28,112
1329,33,36,29,35,133
1330,33,31,28,34,126
1331,33,22,31,44,130
1332,32,34,34,25,125
1333,34,28,38,27,127
1334,31,30,23,35,119
1335,29,36,33,28,126
1336,37,26,36,30,129
1337,34,31,35,30,130
1338,39,36,33,35,143
1339,25,24,29,35,113
1340,41,30,29,34,134
1341,28,35,16,26,105
1342,29,33,33,35,130
1343,32,36,28,25,121
1344,33,38,40,27,138
1345,28,29,35,29,121
1346,24,31,32,31,118
1347,38,35,29,29,131
1348,33,28,41,28,130
1349,25,34,33,34,126
1350,37,29,28,34,128
1351,26,40,26,28,120
1352,33,33,27,22,115
1353,36,27,27,22,112
1354,32,40,21,36,129
1355,41,21,30,32,124
1356,22,31,31,34,118
1357,34,33,26,23,116
1358,32,23,33,34,122
1359,24,24,36,36,120
1360,36,23,29,37,125
1361,23,28,27,37,115
1362,27,38,38,35,138
1363,28,29,32,28,117
1364,30,33,31,41,135
1365,39,36,31,24,130
1366,26,30,31,22,109
1367,35,33,29,37,134
1368,27,37,23,31,118
1369,35,37,29,35,136
1370,28,36,33,30,127
1371,28,26,26,33,113
1372,37,22,34,34,127
1373,21,36,35,33,125
1374,40,29,30,35,134
1375,33,34,26,34,127
1376,23,38,44,37,142
1377,29,28,38,33,128
1378,41,32,36,34,143
1379,21,36,36,29,122
1380,25,29,33,30,117
1381,27,39,40,33,139
1382,34,31,20,35,120
1383,28,39,26,40,133
1384,34,32,26,34,126
1385,39,28,28,25,120
1386,29,36,30,45,140
1387,34,28,28,33,123
1388,28,25,18,32,103
1389,41,35,25,26,127
1390,34,32,35,35,136
1391,27,45,25,35,132
1392,39,33,31,26,129
1393,31,22,35,18,106
1394,24,32,31,21,108
1395,30,30,34,33,127
1396,25,28,40,30,123
1397,31,20,28,22,101
1398,34,27,25,37,123
1399,36,31,31,30,128
1400,30,24,39,34,127
1401,33,34,27,32,126
1402,20,33,27,44,124
1403,27,26,37,26,116
1404,32,35,32,22,121
1405,36,30,29,31,126
1406,26,32,38,32,128
1407,39,23,35,25,122
1408,31,24,32,26,113
1409,28,24,19,26,97
1410,32,32,27,23,114
1411,33,34,33,33,133
1412,31,38,31,22,122
1413,24,26,33,31,114
1414,34,27,38,40,139
1415,26,29,33,30,118
1416,34,32,25,21,112
1417,36,25,38,33,132
1418,30,32,29,32,123
1419,20,30,45,24,119
1420,36,25,28,27,116
1421,33,40,29,28,130
1422,25,22,25,30,102
1423,26,23,23,34,106
1424,33,36,23,34,126
1425,28,30,37,26,121
1426,28,32,27,29,116
1427,26,28,36,38,128
1428,26,32,25,26,109
1429,30,30,27,32,119
1430,33,25,30,38,126
1431,34,41,42,35,152
1432,29,34,29,34,126
1433,28,24,34,28,114
1434,36,31,24,26,117
1435,29,30,38,28,125
1436,32,33,37,26,128
1437,39,40,35,33,147
1438,41,31,26,24,122
1439,36,26,32,35,129
1440,38,28,33,39,138
1441,29,35,37,18,119
1442,26,33,36,31,126
1443,41,37,24,21,123
1444,38,24,21,36,119
1445,26,28,32,27,113
1446,37,33,32,21,123
1447,38,29,38,30,135
1448,40,35,24,21,120
1449,29,34,33,34,130
1450,33,26,35,27,121
1451,32,26,39,25,122
1452,29,34,33,29,125
1453,19,21,47,29,116
1454,36,25,31,29,121
1455,28,41,49,35,153
1456,24,35,41,31,131
1457,29,31,30,33,123
1458,36,32,27,29,124
1459,25,41,32,22,120
1460,43,38,30,36,147
1461,24,36,31,34,125
1462,44,32,23,39,138
1463,23,25,38,34,120
1464,29,28,40,25,122
1465,26,31,39,31,127
1466,34,25,28,30,117
1467,28,27,40,46,141
1468,34,34,39,32,139
1469,30,34,28,34,126
1470,34,24,37,33,128
1471,27,34,32,24,117
1472,45,31,33,32,141
1473,30,29,34,29,122
1474,30,36,31,27,124
1475,33,27,34,29,123
1476,36,26,24,27,113
1477,27,22,45,29,123
1478,37,30,35,29,131
1479,31,34,29,30,124
1480,33,39,30,36,138
1481,24,32,30,33,119
1482,32,22,26,31,111
1483,34,30,26,28,118
1484,33,33,36,45,147
1485,36,42,38,29,145
1486,33,33,28,25,119
1487,26,34,38,32,130
1488,38,25,40,39,142
1489,30,42,20,41,133
1490,31,34,35,20,120
1491,32,36,38,27,133
1492,29,23,28,25,105
1493,36,37,26,34,133
1494,39,32,20,34,125
1495,24,32,18,35,109
1496,34,30,41,21,126
1497,25,33,42,17,117
1498,29,26,27,21,103
1499,37,29,33,36,135
1500,26,20,30,43,119
1501,26,35,30,24,115
1502,30,28,27,37,122
1503,33,38,20,28,119
1504,29,33,30,40,132
1505,35,30,32,31,128
1506,31,33,32,25,121
1507,38,19,39,22,118
1508,26,41,34,26,127
1509,36,22,39,20,117
1510,33,35,25,30,123
1511,35,30,41,23,129
1512,23,41,29,32,125
1513,28,28,30,30,116
1514,32,33,33,39,137
1515,29,31,35,28,123
1516,32,38,30,42,142
1517,30,40,39,28,137
1518,35,26,29,34,124
1519,30,32,37,39,138
1520,32,28,36,33,129
1521,31,35,19,28,113
1522,33,27,17,45,122
1523,36,38,31,30,135
1524,31,32,36,35,134
1525,28,30,31,24,113
1526,36,33,35,33,137
1527,31,33,35,18,117
1528,25,25,36,36,122
1529,37,35,35,32,139
1530,25,32,32,37,126
1531,32,34,33,23,122
1532,25,33,34,25,117
1533,40,31,33,34,138
1534,34,23,30,39,126
1535,29,26,35,36,126
1536,29,32,32,32,125
1537,31,32,26,28,117
1538,26,27,39,27,119
1539,33,25,32,38,128
1540,31,30,35,26,122
1541,32,35,31,40,138
1542,37,32,24,36,129
1543,33,28,23,33,117
1544,24,31,28,39,122
1545,36,15,24,38,113
1546,26,38,28,29,121
1547,38,18,36,20,112
1548,34,23,31,30,118
1549,31,32,34,28,125
1550,36,37,30,37,140
1551,33,29,43,41,146
1552,36,22,26,28,112
1553,20,33,28,31,112
1554,31,29,31,32,123
1555,34,32,27,37,130
1556,35,35,23,30,123
1557,28,33,32,35,128
1558,23,27,31,27,108
1559,22,27,27,23,99
1560,28,28,30,28,114
1561,41,26,28,36,131
1562,29,30,26,47,132
1563,24,33,20,26,103
1564,25,27,41,32,125
1565,34,25,30,27,116
1566,26,26,44,35,131
1567,27,31,35,26,119
1568,38,37,33,29,137
1569,35,42,40,23,140
1570,37,29,30,35,131
1571,24,34,38,21,117
1572,27,27,31,24,109
1573,35,27,25,30,117
1574,21,33,20,27,101
1575,31,29,24,34,118
1576,33,40,28,31,132
1577,30,35,32,27,124
1578,35,31,33,28,127
1579,28,21,44,37,130
1580,35,34,40,35,144
1581,29,33,36,35,133
1582,38,28,29,26,121
1583,30,29,40,39,138
1584,35,27,27,39,128
1585,28,22,32,29,111
1586,32,31,26,31,120
1587,22,30,25,27,104
1588,32,34,26,21,113
1589,39,40,24,29,132
1590,28,31,31,38,128
1591,29,27,31,28,115
1592,30,26,36,25,117
1593,30,27,22,37,116
1594,26,39,36,37,138
1595,27,28,31,44,130
1596,28,22,37,23,110
1597,30,30,39,31,130
1598,29,36,41,35,141
1599,40,32,15,29,116
1600,43,30,37,29,139
1601,29,40,24,26,119
1602,36,41,33,37,147
1603,28,25,35,39,127
1604,29,38,36,26,129
1605,27,29,24,29,109
1606,33,31,29,39,132
1607,25,25,31,35,116
1608,35,28,16,26,105
1609,28,34,26,30,118
1610,32,32,31,29,124
1611,24,35,24,35,118
1612,28,27,31,32,118
1613,46,41,36,35,158
1614,32,32,28,25,117
1615,20,37,34,31,122
1616,27,25,31,27,110
1617,28,41,28,24,121
1618,29,32,35,22,118
1619,32,30,31,27,120
1620,25,44,25,33,127
1621,36,24,28,34,122
1622,33,28,26,27,114
1623,32,40,31,33,136
1624,27,35,36,39,137
1625,29,27,30,27,113
1626,27,32,39,21,119
1627,33,30,26,38,127
1628,33,28,41,30,132
1629,35,31,32,34,132
1630,35,36,41,23,135
1631,42,32,24,30,128
1632,24,22,28,22,96
1633,36,35,29,36,136
1634,34,42,20,28,124
1635,29,21,31,30,111
1636,30,40,29,33,132
1637,37,28,34,36,135
1638,27,33,31,30,121
1639,34,26,29,37,126
1640,39,27,32,26,124
1641,25,41,33,37,136
1642,25,24,32,37,118
1643,44,23,33,25,125
1644,22,31,35,31,119
1645,27,28,33,35,123
1646,30,29,30,21,110
1647,27,25,21,39,112
1648,39,31,30,29,129
1649,22,38,28,15,103
1650,35,35,25,30,125
1651,36,22,22,27,107
1652,25,35,36,33,129
1653,42,36,32,36,146
1654,32,33,35,34,134
1655,28,32,34,34,128
1656,34,25,34,46,139
1657,29,38,27,24,118
1658,30,29,39,25,123
1659,34,46,29,25,134
1660,32,27,36,31,126
1661,37,27,28,28,120
1662,23,22,29,23,97
1663,33,35,22,28,118
1664,36,30,31,30,127
1665,31,32,35,27,125
1666,26,31,33,29,119
1667,28,22,47,36,133
1668,34,41,32,29,136
1669,43,20,25,30,118
1670,25,24,32,27,108
1671,27,29,35,38,129
1672,40,24,39,23,126
1673,31,29,37,34,131
1674,37,33,25,29,124
1675,28,34,33,36,131
1676,21,35,29,34,119
1677,32,41,35,21,129
1678,29,32,40,24,125
1679,24,41,29,27,121
1680,32,29,31,31,123
1681,30,37,25,37,129
1682,37,41,30,28,136
1683,29,34,22,38,123
1684,37,27,30,40,134
1685,23,37,33,24,117
1686,30,23,46,21,120
1687,33,37,27,36,133
1688,38,31,25,34,128
1689,27,38,33,34,132
1690,26,27,36,39,128
1691,29,28,37,26,120
1692,33,36,32,21,122
1693,31,25,31,36,123
1694,32,33,35,36,136
1695,30,39,24,31,124
1696,27,28,28,22,105
1697,28,35,31,29,123
1698,34,32,25,27,118
1699,21,39,38,29,127
1700,23,34,32,21,110
1701,28,29,25,49,131
1702,36,31,33,37,137
1703,34,30,23,34,121
1704,37,34,35,31,137
1705,28,31,29,40,128
1706,32,34,23,23,112
1707,33,37,28,38,136
1708,29,15,18,27,89
1709,27,33,28,32,120
1710,26,27,35,38,126
1711,38,28,29,35,130
1712,33,32,37,38,140
1713,43,36,22,33,134
1714,32,33,25,20,110
1715,33,42,37,28,140
1716,38,32,31,30,131
1717,30,30,34,33,127
1718,31,31,40,31,133
1719,28,32,40,25,125
1720,24,35,30,25,114
1721,38,30,27,23,118
1722,29,33,20,28,110
1723,32,26,35,28,121
1724,35,37,33,36,141
1725,23,32,33,39,127
1726,20,37,26,33,116
1727,30,27,23,35,115
1728,23,28,30,35,116
1729,37,37,26,35,135
1730,34,46,32,22,134
1731,37,32,33,30,132
1732,29,34,24,40,127
1733,24,35,21,28,108
1734,43,34,27,34,138
1735,32,41,28,39,140
1736,30,37,28,30,125
1737,29,38,30,35,132
1738,29,27,34,32,122
1739,26,25,31,25,107
1740,33,37,32,29,131
1741,34,33,24,28,119
1742,34,27,31,24,116
1743,29,33,37,24,123
1744,26,34,33,36,129
1745,27,33,36,42,138
1746,25,35,24,25,109
1747,34,37,24,28,123
1748,27,30,33,28,118
1749,38,29,37,25,129
1750,37,30,26,32,125
1751,29,25,39,31,124
1752,46,30,35,35,146
1753,36,32,31,32,131
1754,33,41,31,27,132
1755,41,26,21,30,118
1756,34,34,31,23,122
1757,29,29,29,25,112
1758,22,32,33,25,112
1759,28,24,16,25,93
1760,32,34,40,25,131
1761,28,33,36,33,130
1762,38,31,19,35,123
1763,33,35,25,28,121
1764,39,27,34,24,124
1765,33,36,34,34,137
1766,37,42,33,30,142
1767,32,37,26,25,120
1768,38,32,22,27,119
1769,23,27,31,21,102
1770,38,48,23,40,149
1771,31,21,23,29,104
1772,32,30,37,19,118
1773,41,32,25,32,130
1774,25,32,31,36,124
1775,25,32,25,22,104
1776,34,26,30,33,123
1777,34,44,36,25,139
1778,36,35,38,28,137
1779,25,36,30,37,128
1780,27,28,34,37,126
1781,35,32,31,29,127
1782,37,34,23,27,121
1783,23,26,28,34,111
1784,35,31,35,29,130
1785,20,25,29,35,109
1786,32,33,32,33,130
1787,34,31,26,30,121
1788,26,28,30,41,125
1789,40,27,37,36,140
1790,22,29,20,31,102
1791,30,33,35,30,128
1792,28,31,33,41,133
1793,23,41,32,28,124
1794,27,21,30,31,109
1795,43,31,29,43,146
1796,37,20,27,34,118
1797,33,18,31,32,114
1798,26,28,33,30,117
1799,30,25,30,24,109
1800,31,34,25,25,115
1801,32,26,31,26,115
1802,32,27,30,22,111
1803,32,33,34,30,129
1804,37,26,32,28,123
1805,27,31,35,31,124
1806,24,28,25,31,108
1807,33,29,36,29,127
1808,38,17,32,32,119
1809,25,30,33,38,126
1810,29,38,34,29,130
1811,23,28,33,39,123
1812,38,24,42,30,134
1813,29,23,37,32,121
1814,31,36,32,34,133
1815,29,31,32,28,120
1816,25,30,39,22,116
1817,34,35,27,26,122
1818,26,28,34,28,116
1819,33,27,31,41,132
1820,27,28,27,41,123
1821,28,34,33,30,125
1822,31,39,36,30,136
1823,30,29,25,25,109
1824,37,37,28,32,134
1825,38,29,36,25,128
1826,28,39,24,31,122
1827,33,29,33,25,120
1828,35,26,30,34,125
1829,36,28,35,27,126
1830,23,43,31,31,128
1831,31,39,36,35,141
1832,35,32,30,26,123
1833,27,27,32,23,109
1834,31,34,25,35,125
1835,27,31,32,38,128
1836,31,37,25,27,120
1837,32,28,36,30,126
1838,32,27,22,26,107
1839,29,27,38,35,129
1840,29,24,32,30,115
1841,29,36,35,31,131
1842,24,25,30,32,111
1843,24,34,29,30,117
1844,36,30,32,24,122
1845,34,26,32,35,127
1846,28,27,31,47,133
1847,35,36,26,32,129
1848,29,25,36,33,123
1849,28,32,40,34,134
1850,33,35,40,26,134
1851,37,30,32,31,130
1852,34,27,24,40,125
1853,32,27,30,28,117
1854,20,24,25,32,101
1855,27,26,36,29,118
1856,32,41,25,24,122
1857,40,35,35,29,139
1858,26,36,35,25,122
1859,37,25,32,26,120
1860,37,42,22,18,119
1861,33,27,26,34,120
1862,29,23,29,26,107
1863,43,21,38,36,138
1864,35,36,27,33,131
1865,35,31,29,38,133
1866,28,31,38,31,128
1867,29,33,35,35,132
1868,36,33,26,31,126
1869,35,32,23,29,119
1870,49,28,26,29,132
1871,35,39,25,26,125
1872,37,33,33,28,131
1873,26,37,32,20,115
1874,37,27,30,26,120
1875,29,30,34,36,129
1876,30,33,35,31,129
1877,25,36,32,18,111
1878,31,27,26,37,121
1879,29,30,32,36,127
1880,30,23,29,29,111
1881,32,34,39,33,138
1882,31,35,41,26,133
1883,36,29,29,36,130
1884,29,32,40,44,145
1885,30,31,41,38,140
1886,29,25,23,23,100
1887,26,21,34,34,115
1888,28,25,29,30,112
1889,19,24,40,32,115
1890,38,24,35,40,137
1891,24,27,31,35,117
1892,35,39,26,31,131
1893,34,31,33,29,127
1894,28,33,36,34,131
1895,28,30,44,24,126
1896,39,42,27,33,141
1897,36,31,32,29,128
1898,38,34,31,24,127
1899,38,27,23,25,113
1900,32,35,29,31,127
1901,25,36,33,28,122
1902,21,37,39,31,128
1903,36,35,29,23,123
1904,28,28,40,30,126
1905,35,29,25,35,124
1906,32,34,31,29,126
1907,23,26,27,35,111
1908,33,34,39,25,131
1909,32,31,32,34,129
1910,22,40,30,26,118
1911,37,29,34,36,136
1912,25,34,30,25,114
1913,27,35,31,26,119
1914,40,40,28,38,146
1915,33,28,27,29,117
1916,37,34,29,37,137
1917,26,24,33,33,116
1918,25,30,27,31,113
1919,33,32,32,31,128
1920,30,26,30,32,118
1921,33,29,32,38,132
1922,23,30,41,28,122
1923,36,43,28,25,132
1924,32,29,39,33,133
1925,34,25,29,39,127
1926,25,27,32,32,116
1927,34,28,29,33,124
1928,38,36,32,37,143
1929,34,22,31,38,125
1930,34,44,32,25,135
1931,24,39,27,36,126
1932,27,38,29,28,122
1933,27,32,28,35,122
1934,38,24,27,36,125
1935,29,37,34,28,128
1936,23,34,35,28,120
1937,30,37,36,31,134
1938,22,34,32,36,124
1939,41,24,26,29,120
1940,25,30,30,34,119
1941,27,30,33,30,120
1942,37,31,31,34,133
1943,37,29,37,24,127
1944,29,25,32,26,112
1945,27,34,33,27,121
1946,30,37,31,26,124
1947,32,35,27,35,129
1948,29,23,38,21,111
1949,26,35,33,26,120
1950,37,22,34,31,124
1951,36,35,24,31,126
1952,40,28,24,29,121
1953,18,25,20,40,103
1954,34,36,23,40,133
1955,29,33,24,31,117
1956,27,43,30,14,114
1957,21,30,35,32,118
1958,45,31,24,37,137
1959,35,39,38,40,152
1960,30,32,30,36,128
1961,32,24,25,34,115
1962,25,34,33,43,135
1963,32,26,40,38,136
1964,32,35,26,28,121
1965,42,28,43,29,142
1966,33,35,26,33,127
1967,35,31,23,29,118
1968,36,25,28,36,125
1969,30,23,30,21,104
1970,39,32,31,31,133
1971,31,42,27,29,129
1972,28,35,27,45,135
1973,30,29,25,23,107
1974,37,28,27,30,122
1975,37,30,27,34,128
1976,37,36,34,28,135
1977,25,20,36,27,108
1978,34,25,33,31,123
1979,37,24,33,28,122
1980,23,29,38,31,121
1981,32,28,28,24,112
1982,36,37,27,38,138
1983,33,21,40,18,112
1984,28,38,36,34,136
1985,35,32,26,36,129
1986,25,23,30,27,105
1987,33,38,29,23,123
1988,24,34,33,30,121
1989,33,26,32,28,119
1990,32,28,30,36,126
1991,26,26,33,38,123
1992,22,28,26,37,113
1993,24,29,34,29,116
1994,32,23,36,26,117
1995,30,26,31,34,121
1996,38,38,22,44,142
1997,25,25,35,25,110
1998,29,42,37,27,135
1999,31,27,20,40,118
2000,29,43,25,32,129
2001,37,28,38,41,144
2002,28,26,30,34,118
2003,31,32,30,33,126
2004,28,20,25,40,113
2005,32,32,35,23,122
2006,27,27,41,27,122
2007,33,39,28,27,127
2008,24,26,35,35,120
2009,26,39,27,33,125
2010,29,16,27,18,90
2011,37,26,32,29,124
2012,32,33,38,30,133
2013,34,32,31,29,126
2014,28,27,28,28,111
2015,31,22,25,29,107
2016,24,31,32,29,116
2017,29,26,25,27,107
2018,37,30,39,33,139
2019,34,42,28,37,141
2020,28,31,40,26,125
2021,35,28,28,30,121
2022,28,34,31,26,119
2023,30,33,38,21,122
2024,36,26,24,25,111
2025,41,29,41,25,136
2026,24,33,36,23,116
2027,34,35,33,28,130
2028,19,34,40,34,127
2029,43,30,29,27,129
2030,26,39,26,23,114
2031,25,24,36,30,115
2032,35,33,27,32,127
2033,32,36,42,26,136
2034,29,41,32,32,134
2035,30,34,28,38,130
2036,27,27,31,37,122
2037,26,34,34,36,130
2038,24,26,41,26,117
2039,33,27,40,23,123
2040,27,31,30,29,117
2041,32,41,31,24,128
2042,36,29,27,37,129
2043,32,28,30,40,130
2044,25,19,31,31,106
2045,29,30,35,27,121
2046,27,30,26,29,112
2047,36,30,29,33,128
2048,36,34,34,31,135
2049,32,36,35,34,137
2050,29,32,29,26,116
2051,28,33,46,30,137
2052,31,42,31,29,133
2053,32,28,33,36,129
2054,34,33,23,25,115
2055,27,24,31,31,113
2056,38,36,34,33,141
2057,37,29,34,25,125
2058,56,23,25,23,127
2059,35,31,24,35,125
2060,29,38,21,25,113
2061,34,29,26,31,120
2062,35,32,39,19,125
2063,28,31,33,33,125
2064,33,45,32,31,141
2065,31,36,31,34,132
2066,32,33,34,29,128
2067,27,32,30,33,122
2068,45,44,29,34,152
2069,25,38,40,29,132
2070,21,22,27,18,88
2071,33,24,33,36,126
2072,22,42,34,23,121
2073,40,33,26,24,123
2074,37,45,27,27,136
2075,26,30,32,27,115
2076,23,23,40,38,124
2077,30,41,43,27,141
2078,29,25,27,36,117
2079,30,28,35,34,127
2080,31,33,35,26,125
2081,36,37,30,23,126
2082,40,30,29,29,128
2083,35,28,30,30,123
2084,19,36,29,28,112
2085,39,42,35,32,148
2086,27,32,27,35,121
2087,31,34,40,36,141
2088,45,28,41,30,144
2089,30,40,29,34,133
2090,26,25,32,29,112
2091,33,34,28,35,130
2092,27,26,40,31,124
2093,34,34,28,33,129
2094,27,23,27,41,118
2095,35,38,21,31,125
2096,22,31,25,38,116
2097,30,40,29,30,129
2098,26,35,25,27,113
2099,35,29,30,30,124
2100,28,26,37,34,125
2101,27,32,35,36,130
2102,28,33,34,33,128
2103,23,41,34,31,129
2104,26,25,31,43,125
2105,33,36,25,35,129
2106,49,32,27,45,153
2107,31,30,30,29,120
2108,30,35,27,25,117
2109,40,39,30,35,144
2110,28,30,30,25,113
2111,35,34,35,26,130
2112,26,35,25,29,115
2113,30,28,32,20,110
2114,38,31,31,32,132
2115,29,27,29,33,118
2116,24,28,29,28,109
2117,22,31,28,41,122
2118,35,29,28,32,124
2119,32,40,31,28,131
2120,29,35,23,33,120
2121,34,29,36,37,136
2122,32,36,27,25,120
2123,33,34,23,32,122
2124,21,36,28,33,118
2125,26,38,38,30,132
2126,34,27,31,28,120
2127,43,42,27,35,147
2128,30,38,42,16,126
2129,28,28,26,29,111
2130,38,35,31,37,141
2131,22,36,27,42,127
2132,26,31,28,35,120
2133,24,40,37,33,134
2134,36,30,36,32,134
2135,31,30,33,27,121
2136,33,29,31,38,131
2137,27,25,35,30,117
2138,34,27,31,31,123
2139,36,35,31,30,132
2140,32,28,36,22,118
2141,29,33,33,25,120
2142,34,36,26,20,116
2143,26,25,33,39,123
2144,34,29,26,30,119
2145,38,31,26,25,120
2146,29,19,22,32,102
2147,33,27,34,25,119
2148,31,35,33,25,124
2149,35,28,26,30,119
2150,33,33,32,23,121
2151,21,39,36,24,120
2152,34,31,28,30,123
2153,29,31,29,40,129
2154,38,39,30,30,137
2155,31,32,37,33,133
2156,32,39,31,38,140
2157,25,44,26,28,123
2158,35,27,35,38,135
2159,28,33,33,36,130
2160,24,26,37,33,120
2161,36,30,24,34,124
2162,28,30,26,31,115
2163,32,36,29,25,122
2164,29,31,30,25,115
2165,23,25,32,29,109
2166,38,29,34,22,123
2167,28,35,28,30,121
2168,27,34,37,30,128
2169,38,31,26,30,125
2170,25,38,37,26,126
2171,26,31,43,28,128
2172,35,30,36,30,131
2173,31,34,32,28,125
2174,37,25,31,39,132
2175,24,37,42,38,141
2176,30,30,30,37,127
2177,27,32,35,42,136
2178,29,32,31,33,125
2179,31,31,42,23,127
2180,26,29,37,28,120
2181,26,33,32,31,122
2182,31,32,37,44,144
2183,33,46,25,29,133
2184,34,41,28,36,139
2185,38,32,33,24,127
2186,35,27,42,23,127
2187,34,39,27,30,130
2188,31,45,32,36,144
2189,26,25,41,22,114
2190,30,26,34,34,124
2191,32,29,17,31,109
2192,31,29,31,19,110
2193,29,27,46,33,135
2194,43,28,32,20,123
2195,25,28,36,28,117
2196,28,34,24,33,119
2197,29,35,33,29,126
2198,27,35,28,28,118
2199,25,33,30,31,119
2200,25,41,38,29,133
2201,42,28,26,34,130
2202,31,32,29,32,124
2203,32,48,31,32,143
2204,38,23,32,33,126
2205,32,25,28,32,117
2206,36,29,35,28,128
2207,40,28,31,26,125
2208,19,29,36,30,114
2209,28,19,33,31,111
2210,40,26,36,27,129
2211,32,24,28,31,115
2212,29,26,40,32,127
2213,35,38,26,33,132
2214,30,37,28,38,133
2215,30,27,26,31,114
2216,34,24,36,34,128
2217,29,30,23,32,114
2218,37,29,31,42,139
2219,37,24,26,30,117
2220,38,32,22,39,131
2221,26,21,29,36,112
2222,40,31,31,29,131
2223,21,30,32,33,116
2224,37,26,34,31,128
2225,25,33,36,35,129
2226,37,37,35,28,137
2227,29,29,26,37,121
2228,29,37,32,32,130
2229,21,29,32,40,122
2230,35,24,29,27,115
2231,35,37,36,28,136
2232,25,20,38,38,121
2233,25,31,24,28,108
2234,31,35,30,23,119
2235,38,36,38,36,148
2236,33,33,34,30,130
2237,27,28,25,31,111
2238,29,17,25,26,97
2239,31,33,32,27,123
2240,37,28,25,29,119
2241,31,29,38,30,128
2242,30,20,38,35,123
2243,29,27,39,23,118
2244,34,32,33,37,136
2245,25,29,37,37,128
2246,34,26,34,25,119
2247,26,34,35,33,128
2248,24,32,21,29,106
2249,32,29,33,19,113
2250,27,36,32,41,136
2251,36,25,29,20,110
2252,25,35,32,33,125
2253,29,25,28,26,108
2254,29,26,30,32,117
2255,42,25,32,31,130
2256,36,44,33,38,151
2257,41,31,37,29,138
2258,28,37,31,51,147
2259,34,34,36,27,131
2260,29,37,34,26,126
2261,29,30,31,34,124
2262,27,31,34,34,126
2263,26,32,25,36,119
2264,33,27,44,29,133
2265,20,40,36,30,126
2266,29,24,37,28,118
2267,31,26,37,35,129
2268,35,27,29,27,118
2269,25,38,30,35,128
2270,24,28,38,25,115
2271,25,23,31,24,103
2272,38,28,31,31,128
2273,30,30,35,41,136
2274,33,26,39,32,130
2275,29,29,25,34,117
2276,33,28,25,23,109
2277,21,28,32,23,104
2278,29,31,34,33,127
2279,32,31,23,31,117
2280,34,27,24,27,112
2281,31,30,32,22,115
2282,37,19,32,33,121
2283,26,31,35,38,130
2284,33,31,31,30,125
2285,37,32,30,28,127
2286,34,33,22,35,124
2287,40,31,36,34,141
2288,35,28,25,27,115
2289,36,33,31,26,126
2290,33,37,37,30,137
2291,30,23,35,25,113
2292,36,30,32,29,127
2293,30,26,28,21,105
2294,27,33,28,29,117
2295,32,29,38,27,126
2296,35,37,30,30,132
2297,31,32,33,31,127
2298,30,31,41,21,123
2299,35,18,30,31,114
2300,22,33,25,30,110
2301,28,27,33,35,123
2302,23,38,32,28,121
2303,44,28,46,37,155
2304,40,38,23,27,128
2305,27,30,39,39,135
2306,25,25,27,34,111
2307,28,32,22,29,111
2308,36,27,38,40,141
2309,34,34,29,31,128
2310,44,27,29,23,123
2311,22,24,32,44,122
2312,28,30,34,25,117
2313,35,37,34,38,144
2314,31,38,26,37,132
2315,31,25,33,29,118
2316,32,27,33,32,124
2317,34,33,25,28,120
2318,26,34,34,31,125
2319,26,38,38,44,146
2320,28,37,27,46,138
2321,31,34,35,27,127
2322,34,24,21,23,102
2323,33,31,36,24,124
2324,31,26,30,41,128
2325,29,28,30,41,128
2326,31,30,34,34,129
2327,29,27,38,30,124
2328,32,25,27,27,111
2329,39,30,33,31,133
2330,34,43,29,35,141
2331,28,38,33,26,125
2332,23,32,29,40,124
2333,32,35,36,29,132
2334,35,30,25,26,116
2335,36,30,50,25,141
2336,31,23,27,38,119
2337,32,28,41,30,131
2338,30,40,35,29,134
2339,25,28,33,32,118
2340,33,33,33,29,128
2341,41,27,43,23,134
2342,25,27,30,30,112
2343,27,44,45,30,146
2344,35,27,34,32,128
2345,35,32,38,30,135
2346,30,37,36,26,129
2347,31,28,35,37,131
2348,24,29,29,36,118
2349,29,34,28,29,120
2350,37,27,31,28,123
2351,38,39,20,32,129
2352,40,18,34,31,123
2353,35,38,36,20,129
2354,22,34,31,32,119
2355,37,28,25,23,113
2356,37,24,23,32,116
2357,23,28,25,31,107
2358,27,39,37,36,139
2359,33,35,41,31,140
2360,22,32,43,27,124
2361,29,34,33,33,129
2362,26,47,32,30,135
2363,23,22,39,34,118
2364,38,33,27,34,132
2365,27,38,28,32,125
2366,27,24,40,39,130
2367,31,41,25,20,117
2368,30,15,26,34,105
2369,29,26,23,38,116
2370,35,30,32,33,130
2371,32,24,33,41,130
2372,26,30,36,41,133
2373,36,31,31,38,136
2374,29,15,27,34,105
2375,36,27,39,33,135
2376,28,33,31,38,130
2377,29,33,41,21,124
2378,25,26,30,31,112
2379,31,28,35,39,133
2380,36,32,30,38,136
2381,30,28,31,29,118
2382,39,32,29,24,124
2383,32,31,29,38,130
2384,29,29,32,19,109
2385,32,29,36,29,126
2386,28,30,30,35,123
2387,34,32,42,30,138
2388,26,33,30,41,130
2389,26,35,23,39,123
2390,29,22,32,24,107
2391,31,34,28,35,128
2392,21,29,34,33,117
2393,34,32,25,27,118
2394,30,24,26,27,107
2395,32,32,34,28,126
2396,24,36,19,40,119
2397,37,34,21,35,127
2398,32,37,23,44,136
2399,35,43,31,32,141
2400,23,24,29,34,110
2401,31,39,27,22,119
2402,20,29,28,42,119
2403,34,32,37,25,128
2404,26,32,31,34,123
2405,27,37,28,30,122
2406,28,33,39,29,129
2407,28,27,33,40,128
2408,31,32,32,35,130
2409,32,31,32,32,127
2410,30,39,35,36,140
2411,27,29,33,41,130
2412,27,28,29,35,119
2413,28,31,27,30,116
2414,32,32,29,36,129
2415,21,32,29,30,112
2416,35,31,20,30,116
2417,30,20,32,28,110
2418,34,36,26,26,122
2419,30,28,33,33,124
2420,25,40,34,30,129
2421,31,34,33,31,129
2422,28,33,24,27,112
2423,33,27,31,21,112
2424,39,32,35,34,140
2425,22,33,37,34,126
2426,40,31,31,28,130
2427,29,27,31,22,109
2428,32,28,41,36,137
2429,27,36,35,33,131
2430,33,37,32,28,130
2431,30,41,31,36,138
2432,31,28,32,31,122
2433,36,31,24,44,135
2434,26,37,39,30,132
2435,33,31,38,33,135
2436,35,26,31,33,125
2437,32,26,27,35,120
2438,32,29,30,30,121
2439,30,26,34,30,120
2440,35,24,39,28,126
2441,27,34,30,26,117
2442,26,33,27,26,112
2443,32,32,35,32,131
2444,32,27,28,29,116
2445,27,21,38,24,110
2446,35,28,22,20,105
2447,29,32,26,34,121
2448,29,41,32,21,123
2449,26,32,41,25,124
2450,43,34,36,31,144
2451,32,27,33,33,125
2452,30,27,38,26,121
2453,34,32,29,23,118
2454,30,21,37,29,117
2455,33,28,41,30,132
2456,27,37,38,23,125
2457,30,36,36,29,131
2458,30,24,32,32,118
2459,25,39,29,37,130
2460,28,30,31,30,119
2461,32,39,24,38,133
2462,30,26,34,27,117
2463,28,31,35,25,119
2464,35,27,32,37,131
2465,28,46,29,35,138
2466,36,34,45,32,147
2467,37,46,31,35,149
2468,27,36,42,30,135
2469,29,28,31,25,113
2470,33,27,36,33,129
2471,30,33,28,39,130
2472,30,41,28,23,122
2473,27,25,36,41,129
2474,21,23,35,32,111
2475,34,33,26,39,132
2476,33,35,33,25,126
2477,32,34,37,37,140
2478,28,32,30,20,110
2479,34,30,27,30,121
2480,25,29,19,28,101
2481,27,40,23,29,119
2482,45,18,38,32,133
2483,27,29,36,30,122
2484,37,36,32,33,138
2485,25,32,39,24,120
2486,32,28,22,32,114
2487,25,37,39,34,135
2488,28,36,25,28,117
2489,36,27,43,40,146
2490,42,33,28,31,134
2491,29,27,28,31,115
2492,35,33,22,28,118
2493,25,28,26,39,118
2494,35,29,40,34,138
2495,46,33,29,31,139
2496,27,31,31,29,118
2497,35,40,25,35,135
2498,19,37,34,28,118
2499,27,33,25,38,123
2500,25,30,31,25,111
2501,29,36,29,30,124
2502,30,36,32,31,129
2503,26,35,34,37,132
2504,38,24,32,44,138
2505,27,32,25,28,112
2506,36,34,30,25,125
2507,27,36,35,24,122
2508,28,24,34,26,112
2509,41,25,35,25,126
2510,31,30,35,26,122
2511,34,22,25,35,116
2512,24,45,28,24,121
2513,36,38,32,22,128
2514,35,27,32,24,118
2515,37,26,30,22,115
2516,35,30,28,27,120
2517,29,39,32,30,130
2518,28,28,39,37,132
2519,35,28,32,39,134
2520,22,39,29,26,116
2521,35,26,37,29,127
2522,25,33,28,30,116
2523,30,30,29,32,121
2524,32,37,41,36,146
2525,35,30,42,30,137
2526,33,34,32,36,135
2527,43,27,29,37,136
2528,32,25,37,24,118
2529,27,23,26,38,114
2530,26,31,43,21,121
2531,29,38,27,23,117
2532,30,36,29,13,108
2533,37,30,27,37,131
2534,34,29,34,20,117
2535,36,22,29,36,123
2536,35,33,31,38,137
2537,39,36,26,38,139
2538,39,32,40,29,140
2539,33,37,32,37,139
2540,35,33,26,33,127
2541,31,36,37,29,133
2542,28,37,31,40,136
2543,35,36,35,32,138
2544,29,28,36,35,128
2545,33,27,48,34,142
2546,31,29,37,34,131
2547,29,28,26,20,103
2548,27,22,43,45,137
2549,35,29,35,39,138
2550,34,35,28,22,119
2551,28,26,30,28,112
2552,24,32,28,29,113
2553,26,35,38,35,134
2554,29,33,49,22,133
2555,38,25,36,23,122
2556,31,35,29,33,128
2557,32,39,26,37,134
2558,29,27,27,32,115
2559,31,29,25,29,114
2560,27,27,33,36,123
2561,33,24,30,30,117
2562,31,42,23,48,144
2563,33,39,30,31,133
2564,30,35,22,35,122
2565,30,38,24,43,135
2566,40,33,32,26,131
2567,36,26,29,27,118
2568,33,25,26,32,116
2569,45,39,25,35,144
2570,38,27,32,34,131
2571,29,23,31,29,112
2572,30,31,33,30,124
2573,30,35,34,15,114
2574,35,41,31,35,142
2575,33,31,31,26,121
2576,23,29,35,29,116
2577,35,32,32,24,123
2578,36,38,25,34,133
2579,32,14,27,33,106
2580,27,20,25,32,104
2581,25,30,27,34,116
2582,25,23,25,25,98
2583,25,34,28,27,114
2584,24,20,37,36,117
2585,32,37,34,34,137
2586,22,26,41,36,125
2587,29,29,26,35,119
2588,32,31,26,25,114
2589,26,29,29,30,114
2590,32,24,26,25,107
2591,32,26,34,27,119
2592,26,47,38,29,140
2593,31,37,27,24,119
2594,35,30,34,40,139
2595,29,33,37,36,135
2596,26,35,23,22,106
2597,24,31,35,30,120
2598,28,22,35,20,105
2599,30,26,32,29,117
2600,30,19,26,35,110
2601,35,36,32,32,135
2602,42,21,30,33,126
2603,31,24,32,25,112
2604,37,27,42,19,125
2605,26,24,23,30,103
2606,35,30,30,35,130
2607,28,24,30,37,119
2608,35,26,33,23,117
2609,33,29,38,25,125
2610,33,28,37,33,131
2611,41,24,26,27,118
2612,30,30,31,29,120
2613,25,40,36,34,135
2614,41,30,22,36,129
2615,30,27,26,29,112
2616,31,26,38,32,127
2617,34,29,30,30,123
2618,23,33,29,42,127
2619,26,33,34,28,121
2620,21,32,22,36,111
2621,32,41,35,32,140
2622,28,28,45,29,130
2623,33,29,23,38,123
2624,29,27,25,33,114
2625,29,37,31,26,123
2626,30,42,32,26,130
2627,36,29,29,25,119
2628,23,37,25,23,108
2629,30,28,40,34,132
2630,30,25,36,34,125
2631,36,28,24,30,118
2632,39,30,36,25,130
2633,31,29,30,31,121
2634,41,31,42,23,137
2635,23,32,33,30,118
2636,39,38,33,31,141
2637,31,36,31,31,129
2638,24,24,26,28,102
2639,27,21,37,34,119
2640,38,32,32,33,135
2641,31,25,35,27,118
2642,23,39,38,33,133
2643,20,22,32,45,119
2644,25,41,22,30,118
2645,32,23,30,28,113
2646,21,32,33,36,122
2647,31,27,36,40,134
2648,29,36,32,23,120
2649,34,31,33,32,130
2650,22,29,31,27,109
2651,41,27,30,31,129
2652,43,32,27,37,139
2653,31,32,34,37,134
2654,26,28,26,28,108
2655,29,35,28,29,121
2656,27,33,29,28,117
2657,32,35,40,30,137
2658,32,31,34,40,137
2659,29,30,28,32,119
2660,29,31,34,29,123
2661,36,29,29,35,129
2662,37,39,25,26,127
2663,29,34,24,29,116
2664,26,29,30,43,128
2665,34,33,25,32,124
2666,29,26,30,29,114
2667,31,25,27,28,111
2668,38,28,42,25,133
2669,29,26,26,31,112
2670,37,27,25,30,119
2671,27,32,32,33,124
2672,30,38,24,31,123
2673,26,30,47,30,133
2674,30,27,31,34,122
2675,26,30,29,28,113
2676,40,28,36,30,134
2677,30,32,32,35,129
2678,31,41,26,35,133
2679,28,33,37,25,123
2680,26,41,40,30,137
2681,36,29,33,39,137
2682,22,34,44,35,135
2683,32,27,38,35,132
2684,37,31,33,33,134
2685,26,35,26,41,128
2686,24,30,36,40,130
2687,31,27,33,29,120
2688,27,23,34,28,112
2689,23,40,33,28,124
2690,32,39,26,40,137
2691,32,31,22,31,116
2692,26,32,34,25,117
2693,32,31,37,33,133
2694,44,32,34,30,140
2695,29,28,25,30,112
2696,31,33,20,33,117
2697,27,23,30,32,112
2698,33,27,39,29,128
2699,43,30,23,24,120
2700,17,36,27,25,105
2701,34,41,39,32,146
2702,31,31,30,36,128
2703,30,33,35,41,139
2704,35,19,32,37,123
2705,34,24,26,29,113
2706,38,18,41,32,129
2707,33,27,32,32,124
2708,40,27,23,33,123
2709,26,27,24,31,108
2710,28,30,34,32,124
2711,28,39,38,37,142
2712,37,29,26,28,120
2713,23,35,33,30,121
2714,39,32,29,20,120
2715,29,25,36,32,122
2716,40,28,35,31,134
2717,35,41,36,38,150
2718,33,30,29,40,132
2719,37,34,28,35,134
2720,34,27,32,41,134
2721,29,30,29,24,112
2722,36,37,27,31,131
2723,24,28,32,29,113
2724,24,33,27,36,120
2725,31,26,38,32,127
2726,20,35,20,32,107
2727,26,20,24,30,100
2728,30,40,37,28,135
2729,49,31,40,34,154
2730,26,28,29,32,115
2731,29,28,33,19,109
2732,32,28,33,22,115
2733,42,22,22,35,121
2734,30,35,39,23,127
2735,25,20,33,37,115
2736,24,25,30,38,117
2737,25,37,29,37,128
2738,28,42,36,21,127
2739,35,33,34,26,128
2740,38,26,35,37,136
2741,29,31,28,21,109
2742,27,36,24,27,114
2743,34,23,27,36,120
2744,30,40,38,29,137
2745,31,42,34,31,138
2746,35,31,36,34,136
2747,30,41,31,22,124
2748,27,34,33,32,126
2749,39,33,28,39,139
2750,26,24,35,27,112
2751,23,37,31,32,123
2752,27,29,30,37,123
2753,27,31,37,31,126
2754,34,26,34,25,119
2755,32,30,30,32,124
2756,38,40,29,34,141
2757,31,34,33,26,124
2758,24,39,27,27,117
2759,25,23,37,24,109
2760,34,37,28,28,127
2761,26,26,28,31,111
2762,21,41,27,32,121
2763,30,32,23,44,129
2764,22,26,25,25,98
2765,34,36,31,38,139
2766,25,26,30,28,109
2767,24,32,31,30,117
2768,36,28,31,41,136
2769,31,27,38,40,136
2770,38,26,32,27,123
2771,30,27,28,22,107
2772,33,20,34,25,112
2773,42,34,28,25,129
2774,32,29,30,28,119
2775,31,31,28,36,126
2776,35,20,39,21,115
2777,31,31,28,25,115
2778,30,27,33,34,124
2779,36,35,23,36,130
2780,43,26,35,27,131
2781,26,36,28,25,115
2782,30,35,29,39,133
2783,30,32,32,29,123
2784,38,32,29,43,142
2785,33,25,29,35,122
2786,35,28,27,25,115
2787,27,24,29,42,122
2788,24,23,27,41,115
2789,38,32,25,45,140
2790,39,32,21,27,119
2791,29,23,32,32,116
2792,36,27,36,36,135
2793,38,32,24,37,131
2794,25,33,33,35,126
2795,37,33,34,29,133
2796,25,28,29,37,119
2797,34,28,30,44,136
2798,32,22,30,40,124
2799,41,28,32,30,131
2800,19,31,40,28,118
2801,28,32,34,29,123
2802,25,31,39,31,126
2803,27,34,40,38,139
2804,28,31,34,24,117
2805,37,35,27,34,133
2806,37,27,34,32,130
2807,29,27,33,28,117
2808,30,31,26,28,115
2809,31,23,27,26,107
2810,30,29,31,30,120
2811,35,24,34,31,124
2812,26,26,26,39,117
2813,35,21,32,35,123
2814,30,38,31,32,131
2815,33,29,29,31,122
2816,30,45,26,23,124
2817,38,21,32,35,126
2818,29,24,30,37,120
2819,32,23,32,33,120
2820,21,30,32,27,110
2821,36,23,24,27,110
2822,34,28,31,27,120
2823,40,23,29,25,117
2824,27,31,24,32,114
2825,25,28,42,30,125
2826,37,30,38,29,134
2827,31,28,38,38,135
2828,27,25,33,39,124
2829,28,32,35,30,125
2830,26,34,25,33,118
2831,27,39,23,36,125
2832,30,27,26,34,117
2833,33,32,42,27,134
2834,35,24,30,29,118
2835,36,32,34,27,129
2836,28,37,22,25,112
2837,29,44,27,35,135
2838,37,28,27,29,121
2839,31,45,33,32,141
2840,16,41,25,27,109
2841,35,32,42,33,142
2842,25,31,34,23,113
2843,39,30,38,38,145
2844,30,33,29,35,127
2845,34,28,41,33,136
2846,27,31,31,38,127
2847,29,35,38,28,130
2848,34,38,29,19,120
2849,26,24,31,30,111
2850,26,34,27,33,120
2851,28,27,39,27,121
2852,20,46,28,26,120
2853,34,27,25,31,117
2854,40,33,30,29,132
2855,36,38,31,31,136
2856,38,23,15,25,101
2857,26,28,33,39,126
2858,33,28,20,32,113
2859,34,23,29,20,106
2860,31,36,38,35,140
2861,32,34,30,35,131
2862,30,31,26,37,124
2863,32,45,48,28,153
2864,28,32,39,27,126
2865,28,29,26,25,108
2866,33,27,30,33,123
2867,28,37,39,29,133
2868,28,41,27,26,122
2869,24,28,27,36,115
2870,36,22,39,26,123
2871,28,30,28,37,123
2872,32,29,24,32,117
2873,35,33,24,40,132
2874,31,35,32,35,133
2875,34,23,37,33,127
2876,28,35,25,28,116
2877,36,40,30,33,139
2878,33,25,22,30,110
2879,30,42,24,33,129
2880,34,22,45,29,130
2881,31,26,30,29,116
2882,32,32,32,29,125
2883,26,33,24,41,124
2884,37,33,41,30,141
2885,30,31,33,33,127
2886,35,28,25,31,119
2887,24,28,35,31,118
2888,25,33,31,37,126
2889,20,34,22,39,115
2890,34,34,31,31,130
2891,33,32,31,40,136
2892,28,28,32,26,114
2893,24,27,31,32,114
2894,30,34,24,31,119
2895,32,33,29,41,135
2896,41,31,28,41,141
2897,31,40,26,29,126
2898,45,40,32,21,138
2899,31,35,27,41,134
2900,32,30,25,31,118
2901,30,38,32,34,134
2902,35,43,33,20,131
2903,37,37,30,41,145
2904,34,22,35,32,123
2905,33,36,16,28,113
2906,34,36,36,32,138
2907,32,32,25,26,115
2908,35,33,27,31,126
2909,34,38,31,26,129
2910,42,26,26,27,121
2911,28,25,20,23,96
2912,41,43,39,21,144
2913,26,23,33,31,113
2914,32,31,34,29,126
2915,34,32,29,33,128
2916,30,27,30,30,117
2917,22,39,27,28,116
2918,30,32,38,26,126
2919,41,29,27,37,134
2920,32,36,25,36,129
2921,23,36,31,31,121
2922,34,23,29,36,122
2923,18,33,37,31,119
2924,29,37,32,26,124
2925,26,32,28,26,112
2926,20,36,25,34,115
2927,34,27,26,25,112
2928,28,26,31,33,118
2929,34,38,28,41,141
2930,45,35,37,23,140
2931,30,39,26,34,129
2932,32,36,42,28,138
2933,37,35,23,29,124
2934,37,23,32,24,116
2935,43,31,21,31,126
2936,30,32,33,34,129
2937,32,28,26,28,114
2938,28,26,35,42,131
2939,34,34,34,38,140
2940,27,30,24,33,114
2941,23,32,33,28,116
2942,42,30,28,37,137
2943,30,33,32,28,123
2944,31,36,31,41,139
2945,31,32,31,39,133
2946,32,39,28,27,126
2947,33,37,31,34,135
2948,33,23,29,30,115
2949,26,24,27,30,107
2950,33,28,25,31,117
2951,36,32,41,32,141
2952,23,32,25,42,122
2953,24,36,32,35,127
2954,29,38,40,28,135
2955,28,24,28,35,115
2956,31,32,41,29,133
2957,34,36,39,30,139
2958,25,33,26,38,122
2959,36,36,28,35,135
2960,24,26,39,31,120
2961,33,22,30,21,106
2962,38,33,24,31,126
2963,31,31,36,34,132
2964,32,25,32,21,110
2965,29,32,34,33,128
2966,30,31,32,30,123
2967,27,27,35,28,117
2968,32,30,33,20,115
2969,26,40,34,24,124
2970,34,31,27,34,126
2971,34,30,40,25,129
2972,24,31,25,28,108
2973,30,38,38,22,128
2974,39,34,28,27,128
2975,30,33,36,26,125
2976,36,32,36,29,133
2977,30,31,23,30,114
2978,26,28,30,29,113
2979,31,25,32,32,120
2980,32,27,27,29,115
2981,34,32,32,24,122
2982,38,30,21,32,121
2983,43,26,26,36,131
2984,37,32,33,29,131
2985,35,33,23,31,122
2986,39,23,30,35,127
2987,32,37,32,31,132
2988,30,33,37,38,138
2989,30,28,31,39,128
2990,28,38,31,38,135
2991,42,29,30,34,135
2992,31,37,34,32,134
2993,37,30,29,37,133
2994,32,27,32,35,126
2995,37,35,39,29,140
2996,34,35,39,32,140
2997,36,28,30,27,121
2998,32,25,29,24,110
2999,36,35,26,28,125
3000,26,25,31,32,114
3001,39,35,36,36,146
3002,30,25,31,28,114
3003,40,28,38,31,137
3004,40,41,25,28,134
3005,33,32,30,32,127
3006,33,37,28,39,137
3007,24,40,28,32,124
3008,35,32,25,37,129
3009,24,26,31,26,107
3010,36,23,39,36,134
3011,28,35,27,25,115
3012,26,38,32,28,124
3013,32,25,32,35,124
3014,17,32,26,28,103
3015,40,24,36,41,141
3016,28,27,34,26,115
3017,26,33,32,34,125
3018,22,33,24,28,107
3019,29,24,38,27,118
3020,31,20,28,27,106
3021,35,31,28,34,128
3022,42,30,36,27,135
3023,36,37,32,33,138
3024,30,29,22,22,103
3025,30,39,39,33,141
3026,28,38,29,37,132
3027,24,24,30,31,109
3028,31,32,33,26,122
3029,36,36,38,26,136
3030,24,28,28,27,107
3031,34,33,35,39,141
3032,36,31,34,34,135
3033,25,27,36,30,118
3034,24,22,27,30,103
3035,32,25,31,32,120
3036,36,32,37,24,129
3037,37,42,29,28,136
3038,28,29,37,36,130
3039,24,31,31,42,128
3040,25,29,41,27,122
3041,24,30,33,27,114
3042,36,24,35,32,127
3043,25,40,27,28,120
3044,40,28,20,26,114
3045,27,32,34,30,123
3046,22,35,33,42,132
3047,33,35,34,34,136
3048,36,33,37,22,128
3049,27,26,29,28,110
3050,33,30,27,31,121
3051,30,28,30,33,121
3052,26,35,26,23,110
3053,24,25,40,33,122
3054,26,39,33,36,134
3055,34,37,26,35,132
3056,30,31,29,33,123
3057,33,32,34,32,131
3058,30,30,39,41,140
3059,34,35,30,27,126
3060,39,37,22,35,133
3061,36,32,34,29,131
3062,27,36,31,37,131
3063,31,31,32,34,128
3064,31,31,24,34,120
3065,28,27,30,28,113
3066,37,29,32,28,126
3067,30,34,39,31,134
3068,27,30,23,26,106
3069,29,29,34,26,118
3070,28,36,33,30,127
3071,32,37,38,24,131
3072,24,34,33,29,120
3073,28,29,34,34,125
3074,39,29,30,34,132
3075,40,32,41,26,139
3076,31,27,36,30,124
3077,27,36,31,24,118
3078,23,33,32,35,123
3079,25,30,29,32,116
3080,31,29,29,29,118
3081,32,30,39,40,141
3082,32,26,36,28,122
3083,31,30,36,39,136
3084,25,39,32,30,126
3085,33,27,30,29,119
3086,33,26,27,32,118
3087,32,32,21,34,119
3088,35,31,34,16,116
3089,30,28,25,40,123
3090,31,24,29,26,110
3091,30,29,30,28,117
3092,26,25,26,33,110
3093,27,28,30,34,119
3094,33,36,39,28,136
3095,33,33,28,31,125
3096,33,32,29,31,125
3097,29,23,23,37,112
3098,30,30,37,31,128
3099,31,41,32,29,133
3100,24,22,34,32,112
3101,28,37,24,25,114
3102,37,29,20,39,125
3103,40,28,39,39,146
3104,21,32,40,23,116
3105,37,26,29,40,132
3106,41,29,32,25,127
3107,20,43,31,29,123
3108,42,22,48,32,144
3109,30,28,36,34,128
3110,41,37,30,28,136
3111,30,41,33,28,132
3112,34,30,39,33,136
3113,39,30,40,36,145
3114,19,32,30,27,108
3115,32,29,24,29,114
3116,38,28,26,29,121
3117,40,35,35,29,139
3118,32,34,38,33,137
3119,26,25,37,27,115
3120,32,34,29,36,131
3121,25,32,25,39,121
3122,34,29,32,31,126
3123,25,24,30,28,107
3124,40,37,27,29,133
3125,25,26,31,19,101
3126,27,31,40,28,126
3127,31,20,25,29,105
3128,34,30,41,31,136
3129,37,33,28,36,134
3130,36,30,31,26,123
3131,30,35,33,27,125
3132,35,37,36,25,133
3133,24,32,28,32,116
3134,38,35,35,33,141
3135,25,32,33,32,122
3136,27,26,36,37,126
3137,32,18,30,27,107
3138,33,38,35,34,140
3139,33,31,30,35,129
3140,34,28,29,42,133
3141,48,26,35,30,139
3142,38,33,34,39,144
3143,31,25,36,26,118
3144,20,36,31,35,122
3145,33,27,41,34,135
3146,32,28,31,36,127
3147,34,30,21,37,122
3148,25,33,46,29,133
3149,25,32,30,36,123
3150,37,35,30,28,130
3151,25,30,28,28,111
3152,28,23,36,25,112
3153,25,26,23,31,105
3154,37,25,24,36,122
3155,28,29,39,27,123
3156,29,32,22,33,116
3157,31,34,33,33,131
3158,34,35,31,28,128
3159,29,36,34,31,130
3160,28,36,29,27,120
3161,31,25,31,39,126
3162,27,26,38,35,126
3163,27,21,35,38,121
3164,28,28,26,43,125
3165,24,35,26,27,112
3166,33,32,34,29,128
3167,37,40,25,24,126
3168,26,42,28,29,125
3169,24,25,20,36,105
3170,22,41,36,35,134
3171,29,27,27,23,106
3172,25,34,32,26,117
3173,27,21,37,31,116
3174,31,36,32,16,115
3175,36,24,37,23,120
3176,30,28,28,40,126
3177,27,26,29,32,114
3178,27,32,30,35,124
3179,23,29,26,27,105
3180,29,30,33,34,126
3181,34,30,23,36,123
3182,26,22,32,28,108
3183,33,31,37,34,135
3184,36,25,34,28,123
3185,22,33,31,35,121
3186,39,31,30,26,126
3187,33,18,27,38,116
3188,35,35,16,35,121
3189,24,28,31,27,110
3190,29,25,31,22,107
3191,32,39,30,36,137
3192,25,35,38,34,132
3193,32,26,29,36,123
3194,31,31,24,36,122
3195,40,29,31,31,131
3196,23,32,28,34,117
3197,26,28,39,39,132
3198,27,31,35,28,121
3199,29,22,27,27,105
3200,36,24,38,28,126
3201,31,32,20,28,111
3202,36,33,37,36,142
3203,32,38,38,26,134
3204,35,26,37,37,135
3205,38,34,39,32,143
3206,27,22,27,25,101
3207,32,24,29,32,117
3208,37,21,26,30,114
3209,33,36,29,28,126
3210,25,40,29,32,126
3211,29,27,27,36,119
3212,31,35,31,31,128
3213,31,23,39,33,126
3214,34,37,33,33,137
3215,37,22,38,31,128
3216,38,40,24,35,137
3217,20,33,28,34,115
3218,34,25,26,31,116
3219,31,32,38,43,144
3220,21,36,36,34,127
3221,32,36,30,23,121
3222,29,33,28,36,126
3223,46,31,28,32,137
3224,28,29,24,35,116
3225,35,30,26,34,125
3226,27,34,18,26,105
3227,31,33,36,33,133
3228,28,38,35,28,129
3229,35,35,31,33,134
3230,28,39,29,35,131
3231,26,31,40,37,134
3232,29,39,33,25,126
3233,25,25,36,36,122
3234,27,28,27,26,108
3235,27,31,29,26,113
3236,30,30,32,36,128
3237,35,30,29,41,135
3238,39,28,25,26,118
3239,34,43,39,26,142
3240,26,30,34,25,115
3241,31,30,31,30,122
3242,29,33,25,31,118
3243,31,35,22,35,123
3244,37,34,20,41,132
3245,26,38,32,26,122
3246,28,29,27,31,115
3247,31,34,34,23,122
3248,28,40,32,39,139
3249,27,35,30,32,124
3250,34,23,40,33,130
3251,35,30,25,28,118
3252,27,32,49,34,142
3253,27,36,19,29,111
3254,29,26,27,29,111
3255,32,31,27,33,123
3256,33,26,20,32,111
3257,30,41,35,27,133
3258,36,28,33,24,121
3259,35,27,30,36,128
3260,25,46,28,36,135
3261,33,36,49,28,146
3262,24,32,26,26,108
3263,41,26,21,28,116
3264,27,29,25,36,117
3265,23,26,35,22,106
3266,41,21,38,29,129
3267,34,38,40,32,144
3268,25,20,36,34,115
3269,31,25,30,32,118
3270,33,29,32,21,115
3271,38,31,28,34,131
3272,20,37,28,35,120
3273,38,31,26,36,131
3274,27,34,29,27,117
3275,34,21,31,29,115
3276,32,26,39,40,137
3277,31,34,31,41,137
3278,23,26,28,37,114
3279,32,40,38,28,138
3280,35,26,29,39,129
3281,39,26,27,44,136
3282,33,30,33,37,133
3283,32,42,33,32,139
3284,28,29,27,31,115
3285,26,38,40,27,131
3286,24,46,26,30,126
3287,22,51,36,27,136
3288,30,36,25,32,123
3289,27,40,32,26,125
3290,37,31,36,25,129
3291,32,34,38,32,136
3292,37,45,31,29,142
3293,26,29,39,37,131
3294,30,24,31,35,120
3295,26,40,47,39,152
3296,22,36,21,29,108
3297,30,28,32,31,121
3298,37,30,28,30,125
3299,42,40,25,24,131
3300,27,43,33,37,140
3301,33,34,36,33,136
3302,22,28,33,36,119
3303,41,30,29,22,122
3304,30,32,30,21,113
3305,33,36,20,31,120
3306,27,30,32,34,123
3307,31,42,33,31,137
3308,33,32,32,37,134
3309,34,32,27,32,125
3310,28,25,36,29,118
3311,25,34,31,24,114
3312,31,42,28,28,129
3313,30,30,26,29,115
3314,28,35,44,31,138
3315,32,32,27,39,130
3316,32,30,24,31,117
3317,24,29,29,33,115
3318,30,23,32,18,103
3319,34,29,33,31,127
3320,32,28,29,24,113
3321,30,34,37,31,132
3322,28,41,30,24,123
3323,39,31,31,23,124
3324,34,44,28,32,138
3325,34,35,35,30,134
3326,27,38,25,31,121
3327,30,28,34,24,116
3328,33,28,33,29,123
3329,33,32,23,35,123
3330,33,35,33,30,131
3331,23,44,27,20,114
3332,23,28,25,35,111
3333,33,32,36,25,126
3334,22,32,36,36,126
3335,30,32,48,27,137
3336,35,35,27,25,122
3337,29,29,43,42,143
3338,46,37,40,27,150
3339,44,27,33,29,133
3340,26,23,32,30,111
3341,27,29,33,41,130
3342,30,31,31,35,127
3343,25,25,35,28,113
3344,33,33,33,32,131
3345,33,27,30,30,120
3346,25,38,35,32,130
3347,32,33,36,33,134
3348,20,29,35,39,123
3349,31,31,30,29,121
3350,39,27,29,37,132
3351,28,37,33,26,124
3352,35,30,42,29,136
3353,35,28,35,38,136
3354,44,32,30,23,129
3355,42,35,30,37,144
3356,30,36,22,39,127
3357,23,31,36,33,123
3358,28,40,30,29,127
3359,32,26,20,32,110
3360,28,28,27,26,109
3361,37,37,32,26,132
3362,36,22,32,31,121
3363,29,28,28,38,123
3364,29,31,20,27,107
3365,24,29,27,36,116
3366,28,39,28,33,128
3367,38,24,26,24,112
3368,43,33,30,34,140
3369,21,41,22,31,115
3370,27,44,31,34,136
3371,30,38,37,29,134
3372,23,41,32,29,125
3373,33,25,29,36,123
3374,37,23,34,32,126
3375,26,29,33,41,129
3376,31,31,27,38,127
3377,31,20,24,41,116
3378,31,29,29,32,121
3379,32,42,28,32,134
3380,28,32,40,28,128
3381,39,39,25,21,124
3382,29,32,28,30,119
3383,30,30,39,39,138
3384,26,38,38,25,127
3385,41,30,27,34,132
3386,28,43,31,36,138
3387,39,30,23,30,122
3388,38,29,26,15,108
3389,30,26,39,32,127
3390,32,23,27,29,111
3391,28,22,30,27,107
3392,33,27,25,29,114
3393,44,37,37,21,139
3394,29,31,29,33,122
3395,35,34,36,20,125
3396,27,33,33,28,121
3397,29,36,32,31,128
3398,35,30,33,31,129
3399,29,30,29,32,120
3400,37,44,31,31,143
3401,33,25,29,33,120
3402,35,25,26,31,117
3403,37,22,30,34,123
3404,36,30,33,37,136
3405,26,37,36,34,133
3406,26,41,28,20,115
3407,38,33,32,29,132
3408,32,31,39,27,129
3409,24,35,34,27,120
3410,29,36,29,23,117
3411,34,35,38,31,138
3412,34,28,32,31,125
3413,33,30,40,29,132
3414,36,26,31,31,124
3415,28,28,28,28,112
3416,31,27,28,36,122
3417,34,18,24,28,104
3418,31,33,32,30,126
3419,32,34,34,30,130
3420,33,26,33,22,114
3421,29,28,37,28,122
3422,26,31,21,28,106
3423,28,30,38,35,131
3424,36,34,19,28,117
3425,24,32,16,28,100
3426,27,33,28,30,118
3427,36,28,25,33,122
3428,25,33,30,31,119
3429,38,21,25,23,107
3430,30,35,33,36,134
3431,36,24,26,26,112
3432,22,37,31,36,126
3433,31,36,25,31,123
3434,34,26,41,21,122
3435,35,21,31,30,117
3436,35,31,40,24,130
3437,30,30,38,31,129
3438,33,41,32,36,142
3439,34,45,45,32,156
3440,32,36,26,27,121
3441,26,25,25,27,103
3442,23,35,29,31,118
3443,34,22,30,24,110
3444,31,25,35,35,126
3445,40,33,37,27,137
3446,41,32,28,29,130
3447,35,27,33,37,132
3448,58,35,25,28,146
3449,44,23,29,36,132
3450,34,27,29,32,122
3451,34,37,28,26,125
3452,33,36,20,37,126
3453,27,31,38,32,128
3454,39,29,32,26,126
3455,33,24,48,36,141
3456,40,28,28,42,138
3457,36,27,39,32,134
3458,18,29,23,35,105
3459,33,33,35,33,134
3460,24,34,25,38,121
3461,24,30,31,31,116
3462,32,37,27,34,130
3463,41,35,30,24,130
3464,36,32,38,38,144
3465,42,31,35,37,145
3466,26,24,37,38,125
3467,29,32,28,27,116
3468,36,23,31,33,123
3469,32,32,28,33,125
3470,24,42,24,25,115
3471,22,31,32,33,118
3472,30,28,42,34,134
3473,32,30,33,40,135
3474,22,30,29,31,112
3475,31,37,31,33,132
3476,42,29,31,27,129
3477,26,33,39,27,125
3478,30,35,33,26,124
3479,28,32,29,29,118
3480,33,15,31,28,107
3481,28,38,37,23,126
3482,26,29,28,29,112
3483,42,35,27,31,135
3484,32,31,31,29,123
3485,33,37,22,37,129
3486,32,30,35,34,131
3487,31,21,34,38,124
3488,20,29,31,35,115
3489,36,43,27,31,137
3490,28,31,39,37,135
3491,29,24,33,39,125
3492,23,22,39,26,110
3493,34,34,39,34,141
3494,35,30,28,35,128
3495,20,27,32,25,104
3496,33,31,35,29,128
3497,31,21,28,23,103
3498,35,32,23,41,131
3499,33,26,40,31,130
3500,24,27,32,30,113
3501,37,28,38,35,138
3502,26,40,28,29,123
3503,30,33,43,30,136
3504,36,30,43,35,144
3505,35,31,32,30,128
3506,36,28,42,24,130
3507,30,27,28,27,112
3508,36,25,28,39,128
3509,37,25,30,33,125
3510,31,22,28,26,107
3511,34,46,31,33,144
3512,25,38,27,21,111
3513,31,25,30,32,118
3514,31,36,36,29,132
3515,32,38,26,42,138
3516,33,27,27,33,120
3517,30,21,33,30,114
3518,32,36,32,25,125
3519,27,33,23,32,115
3520,27,26,34,31,118
3521,26,42,32,31,131
3522,33,39,32,31,135
3523,26,27,38,31,122
3524,23,33,27,34,117
3525,29,25,35,33,122
3526,21,27,39,28,115
3527,36,27,40,36,139
3528,28,29,34,30,121
3529,25,33,31,30,119
3530,33,48,34,36,151
3531,26,32,35,23,116
3532,33,31,30,33,127
3533,29,33,32,33,127
3534,28,29,33,29,119
3535,32,32,28,33,125
3536,35,23,49,18,125
3537,38,33,23,32,126
3538,31,28,33,30,122
3539,33,29,29,20,111
3540,36,31,36,23,126
3541,26,48,24,29,127
3542,27,34,35,26,122
3543,29,26,32,32,119
3544,28,23,28,33,112
3545,33,33,31,35,132
3546,30,38,36,33,137
3547,24,32,34,34,124
3548,25,38,37,33,133
3549,24,34,22,34,114
3550,36,33,29,33,131
3551,26,30,25,33,114
3552,31,29,35,33,128
3553,35,26,28,31,120
3554,33,20,38,28,119
3555,31,44,30,31,136
3556,28,34,32,32,126
3557,35,27,32,44,138
3558,29,30,28,28,115
3559,23,35,34,29,121
3560,27,36,30,42,135
3561,27,36,39,33,135
3562,34,38,36,37,145
3563,33,25,24,28,110
3564,39,22,26,28,115
3565,33,27,30,37,127
3566,29,28,37,34,128
3567,29,25,34,30,118
3568,24,31,30,33,118
3569,31,24,31,36,122
3570,30,31,32,27,120
3571,41,37,26,31,135
3572,32,30,25,29,116
3573,32,34,24,39,129
3574,27,29,26,40,122
3575,32,33,29,43,137
3576,26,34,37,22,119
3577,29,33,33,24,119
3578,35,26,32,33,126
3579,28,30,38,21,117
3580,24,36,34,23,117
3581,39,32,26,31,128
3582,31,39,26,25,121
3583,29,36,32,40,137
3584,33,29,31,18,111
3585,42,36,34,23,135
3586,33,26,20,42,121
3587,30,37,22,34,123
3588,32,34,31,30,127
3589,43,27,36,43,149
3590,36,28,41,38,143
3591,33,31,35,25,124
3592,32,26,38,36,132
3593,27,31,33,34,125
3594,41,30,35,32,138
3595,28,31,15,35,109
3596,29,25,32,26,112
3597,26,29,34,29,118
3598,37,33,33,24,127
3599,32,34,33,37,136
3600,38,41,37,32,148
3601,25,27,36,38,126
3602,28,28,36,28,120
3603,26,38,20,31,115
3604,32,29,27,34,122
3605,29,33,24,24,110
3606,45,26,18,31,120
3607,29,31,32,28,120
3608,37,26,28,34,125
3609,32,42,29,20,123
3610,24,27,31,37,119
3611,34,34,22,32,122
3612,23,36,26,33,118
3613,27,27,37,36,127
3614,27,25,44,27,123
3615,35,29,22,25,111
3616,36,33,40,31,140
3617,28,36,31,30,125
3618,23,29,39,20,111
3619,37,33,30,27,127
3620,21,32,35,30,118
3621,31,32,33,28,124
3622,30,48,31,34,143
3623,26,34,30,32,122
3624,29,29,27,35,120
3625,29,39,25,26,119
3626,26,42,33,24,125
3627,35,40,24,23,122
3628,27,30,41,32,130
3629,26,28,33,34,121
3630,23,34,35,38,130
3631,24,31,33,34,122
3632,24,37,36,31,128
3633,34,38,48,30,150
3634,26,32,28,29,115
3635,34,31,32,36,133
3636,30,32,40,34,136
3637,28,32,28,41,129
3638,31,31,29,37,128
3639,30,26,33,32,121
3640,32,27,32,39,130
3641,20,23,29,31,103
3642,27,37,18,32,114
3643,28,31,34,28,121
3644,26,31,44,29,130
3645,33,40,24,39,136
3646,32,28,24,31,115
3647,37,29,35,31,132
3648,36,31,28,34,129
3649,26,34,25,39,124
3650,24,35,35,36,130
3651,37,31,36,28,132
3652,35,28,42,28,133
3653,31,27,25,30,113
3654,27,34,23,28,112
3655,24,24,31,33,112
3656,32,26,39,19,116
3657,27,29,30,32,118
3658,35,33,37,28,133
3659,28,34,23,37,122
3660,31,36,49,24,140
3661,36,31,33,32,132
3662,29,34,31,33,127
3663,47,41,24,34,146
3664,35,32,37,33,137
3665,29,38,30,29,126
3666,38,38,29,24,129
3667,30,22,31,29,112
3668,32,31,31,29,123
3669,31,41,33,38,143
3670,31,30,32,22,115
3671,32,29,38,25,124
3672,29,25,42,37,133
3673,31,43,25,28,127
3674,31,31,25,21,108
3675,36,42,31,26,135
3676,38,39,21,37,135
3677,37,27,33,35,132
3678,28,42,30,26,126
3679,32,30,31,28,121
3680,33,28,29,38,128
3681,28,36,36,30,130
3682,25,31,33,33,122
3683,35,28,33,21,117
3684,24,29,17,30,100
3685,31,39,28,33,131
3686,31,33,28,29,121
3687,34,28,31,34,127
3688,35,31,29,38,133
3689,32,26,29,36,123
3690,30,25,29,30,114
3691,25,42,35,32,134
3692,39,28,41,30,138
3693,21,22,28,33,104
3694,22,39,34,32,127
3695,26,29,30,28,113
3696,26,25,33,39,123
3697,33,40,28,26,127
3698,29,35,37,32,133
3699,24,39,28,32,123
3700,28,35,31,27,121
3701,38,39,27,26,130
3702,25,41,33,31,130
3703,37,29,26,28,120
3704,35,26,32,26,119
3705,34,33,27,28,122
3706,31,31,35,31,128
3707,32,31,26,39,128
3708,29,45,23,35,132
3709,24,23,39,25,111
3710,31,28,29,29,117
3711,26,33,34,36,129
3712,32,28,45,27,132
3713,30,30,28,33,121
3714,19,26,36,34,115
3715,35,29,36,28,128
3716,33,30,33,28,124
3717,24,36,35,27,122
3718,32,19,39,34,124
3719,36,27,24,30,117
3720,22,27,36,29,114
3721,31,29,34,36,130
3722,28,40,33,32,133
3723,31,33,28,33,125
3724,28,28,32,33,121
3725,34,27,22,30,113
3726,48,24,33,27,132
3727,31,32,24,32,119
3728,25,31,33,32,121
3729,38,26,31,26,121
3730,30,31,26,31,118
3731,32,31,34,29,126
3732,42,24,31,22,119
3733,35,39,34,43,151
3734,29,26,29,39,123
3735,32,28,35,41,136
3736,27,31,32,26,116
3737,35,31,31,35,132
3738,36,28,37,41,142
3739,35,33,42,37,147
3740,37,29,30,27,123
3741,29,32,24,27,112
3742,30,30,32,33,125
3743,30,29,27,32,118
3744,19,27,30,40,116
3745,28,39,36,22,125
3746,30,25,44,22,121
3747,23,24,38,35,120
3748,28,28,38,27,121
3749,32,31,30,38,131
3750,33,31,35,37,136
3751,40,22,34,25,121
3752,30,41,29,32,132
3753,23,37,34,38,132
3754,40,31,31,25,127
3755,33,30,29,35,127
3756,36,47,27,19,129
3757,27,31,33,36,127
3758,32,20,37,28,117
3759,40,35,33,26,134
3760,29,31,37,42,139
3761,38,25,25,35,123
3762,26,31,33,31,121
3763,30,27,31,25,113
3764,30,29,28,34,121
3765,31,34,32,32,129
3766,35,32,26,22,115
3767,39,31,23,36,129
3768,28,33,36,34,131
3769,32,41,34,24,131
3770,32,21,29,34,116
3771,27,39,33,40,139
3772,24,30,25,27,106
3773,27,35,35,24,121
3774,32,31,39,26,128
3775,28,32,47,15,122
3776,32,23,30,35,120
3777,22,31,31,25,109
3778,25,40,27,38,130
3779,32,37,36,33,138
3780,36,41,38,31,146
3781,16,39,33,32,120
3782,26,20,37,37,120
3783,35,34,27,33,129
3784,32,30,30,35,127
3785,29,42,36,31,138
3786,28,15,25,31,99
3787,29,25,30,31,115
3788,28,33,36,30,127
3789,34,27,30,27,118
3790,26,34,28,19,107
3791,30,35,28,44,137
3792,30,29,47,33,139
3793,31,40,30,30,131
3794,33,27,28,28,116
3795,41,36,21,32,130
3796,28,27,31,20,106
3797,25,33,32,34,124
3798,36,37,37,33,143
3799,42,30,34,32,138
3800,31,28,29,35,123
3801,31,36,31,29,127
3802,27,35,32,29,123
3803,27,29,33,34,123
3804,35,30,23,37,125
3805,34,36,41,36,147
3806,35,27,43,23,128
3807,28,22,19,31,100
3808,26,24,27,32,109
3809,33,35,40,24,132
3810,37,32,30,31,130
3811,36,39,28,34,137
3812,31,22,34,32,119
3813,28,30,30,22,110
3814,24,33,27,31,115
3815,28,33,30,29,120
3816,44,27,29,27,127
3817,28,37,29,32,126
3818,30,34,34,34,132
3819,25,18,24,29,96
3820,33,33,33,21,120
3821,24,35,29,22,110
3822,29,30,29,24,112
3823,27,32,32,29,120
3824,27,30,50,30,137
3825,32,30,38,32,132
3826,29,31,27,25,112
3827,37,36,28,35,136
3828,36,26,42,26,130
3829,32,30,32,25,119
3830,19,35,28,38,120
3831,33,32,41,32,138
3832,27,24,30,38,119
3833,25,25,34,40,124
3834,37,29,31,24,121
3835,32,33,27,37,129
3836,34,27,37,36,134
3837,26,24,25,25,100
3838,32,31,39,34,136
3839,36,30,26,39,131
3840,34,42,32,36,144
3841,29,35,39,33,136
3842,28,31,28,28,115
3843,41,35,23,23,122
3844,28,23,32,36,119
3845,39,23,28,35,125
3846,38,35,24,36,133
3847,30,32,23,36,121
3848,23,41,42,24,130
3849,31,33,28,27,119
3850,29,31,28,29,117
3851,38,19,33,26,116
3852,33,26,27,42,128
3853,29,27,34,31,121
3854,40,35,30,31,136
3855,31,28,27,30,116
3856,34,34,36,24,128
3857,24,25,36,33,118
3858,36,33,38,34,141
3859,15,22,27,38,102
3860,27,29,27,38,121
3861,32,32,29,34,127
3862,32,22,32,31,117
3863,25,29,32,32,118
3864,29,30,36,27,122
3865,33,36,37,30,136
3866,28,25,24,34,111
3867,22,26,31,30,109
3868,25,24,31,30,110
3869,26,26,27,27,106
3870,25,35,32,26,118
3871,35,32,27,30,124
3872,30,38,32,42,142
3873,37,28,37,30,132
3874,37,28,31,26,122
3875,30,34,31,32,127
3876,37,34,30,27,128
3877,29,40,18,33,120
3878,28,33,31,39,131
3879,30,41,29,35,135
3880,31,39,29,21,120
3881,33,37,39,17,126
3882,33,36,39,22,130
3883,30,37,39,37,143
3884,30,27,25,29,111
3885,24,42,28,32,126
3886,38,28,33,30,129
3887,36,33,35,31,135
3888,26,35,22,28,111
3889,34,27,36,28,125
3890,28,32,32,31,123
3891,35,30,35,24,124
3892,31,29,33,25,118
3893,23,36,36,24,119
3894,34,43,31,31,139
3895,35,31,29,25,120
3896,39,30,29,39,137
3897,35,26,26,23,110
3898,31,23,34,44,132
3899,38,28,31,30,127
3900,29,24,28,33,114
3901,31,40,32,29,132
3902,31,32,32,22,117
3903,30,28,36,27,121
3904,24,43,23,29,119
3905,17,32,31,37,117
3906,27,25,28,30,110
3907,35,30,31,25,121
3908,27,45,32,34,138
3909,27,29,40,28,124
3910,39,25,33,38,135
3911,32,32,40,32,136
3912,22,29,26,52,129
3913,32,24,40,34,130
3914,32,30,33,16,111
3915,27,30,37,29,123
3916,25,24,48,31,128
3917,38,40,25,34,137
3918,28,23,28,22,101
3919,42,17,27,34,120
3920,22,31,37,36,126
3921,29,37,28,37,131
3922,25,35,22,26,108
3923,29,32,32,28,121
3924,36,35,23,40,134
3925,28,31,42,39,140
3926,38,25,34,33,130
3927,33,37,35,18,123
3928,34,26,29,32,121
3929,37,37,29,30,133
3930,32,25,33,31,121
3931,30,33,28,36,127
3932,31,29,31,26,117
3933,38,23,22,34,117
3934,26,33,34,22,115
3935,33,28,29,29,119
3936,37,27,31,31,126
3937,24,30,38,28,120
3938,38,40,42,21,141
3939,24,26,28,24,102
3940,35,23,16,37,111
3941,31,26,33,33,123
3942,32,34,30,33,129
3943,29,39,22,37,127
3944,33,31,28,33,125
3945,27,22,28,36,113
3946,27,23,36,21,107
3947,25,27,33,26,111
3948,33,25,31,35,124
3949,43,27,28,42,140
3950,30,30,23,21,104
3951,42,34,24,17,117
3952,26,40,37,36,139
3953,22,36,32,32,122
3954,31,28,35,33,127
3955,40,30,37,31,138
3956,34,36,35,34,139
3957,30,25,29,24,108
3958,33,30,23,30,116
3959,29,24,31,37,121
3960,30,27,32,27,116
3961,33,27,41,33,134
3962,24,31,27,39,121
3963,32,27,34,32,125
3964,37,36,28,26,127
3965,29,21,26,31,107
3966,27,20,34,35,116
3967,39,31,29,30,129
3968,30,32,21,35,118
3969,31,31,36,28,126
3970,27,37,31,24,119
3971,31,32,21,25,109
3972,34,27,24,28,113
3973,27,23,30,41,121
3974,33,26,36,36,131
3975,39,29,38,34,140
3976,34,39,23,31,127
3977,23,26,42,42,133
3978,21,29,33,38,121
3979,28,30,30,22,110
3980,30,37,29,26,122
3981,33,30,41,39,143
3982,26,35,28,26,115
3983,35,35,29,30,129
3984,29,32,34,33,128
3985,15,32,34,28,109
3986,33,38,29,28,128
3987,26,27,22,29,104
3988,25,28,27,27,107
3989,36,34,34,31,135
3990,21,35,38,32,126
3991,24,29,30,30,113
3992,32,29,28,20,109
3993,32,36,36,18,122
3994,36,33,42,34,145
3995,31,29,32,43,135
3996,30,32,40,30,132
3997,44,33,35,24,136
3998,32,31,28,29,120
3999,27,27,36,27,117
4000,37,34,32,28,131
4001,33,30,32,42,137
4002,33,31,39,31,134
4003,34,31,26,39,130
4004,32,42,15,25,114
4005,35,24,30,31,120
4006,30,32,34,29,125
4007,41,30,34,32,137
4008,28,23,25,45,121
4009,32,33,25,25,115
4010,37,27,42,29,135
4011,36,32,39,35,142
4012,34,33,24,32,123
4013,26,41,26,32,125
4014,34,31,30,33,128
4015,38,32,23,27,120
4016,19,36,35,30,120
4017,32,25,34,29,120
4018,32,30,24,28,114
4019,29,32,30,26,117
4020,37,42,30,31,140
4021,36,28,25,37,126
4022,31,25,27,31,114
4023,33,40,28,20,121
4024,36,29,34,28,127
4025,38,30,38,33,139
4026,35,40,42,39,156
4027,22,34,29,20,105
4028,26,29,31,41,127
4029,34,29,37,36,136
4030,34,31,23,28,116
4031,27,35,36,29,127
4032,33,21,41,25,120
4033,28,32,44,38,142
4034,33,24,32,34,123
4035,32,40,21,35,128
4036,27,26,35,29,117
4037,23,27,26,39,115
4038,30,40,37,30,137
4039,25,27,30,33,115
4040,31,40,27,33,131
4041,27,33,36,32,128
4042,24,26,22,35,107
4043,38,32,30,22,122
4044,30,35,32,27,124
4045,33,38,26,33,130
4046,28,34,30,33,125
4047,31,32,32,27,122
4048,36,23,30,32,121
4049,27,38,27,28,120
4050,38,31,37,41,147
4051,21,32,29,28,110
4052,35,31,31,29,126
4053,32,28,27,29,116
4054,36,35,35,27,133
4055,26,27,31,38,122
4056,29,32,34,26,121
4057,25,32,22,26,105
4058,35,33,34,35,137
4059,26,29,30,33,118
4060,34,34,26,24,118
4061,33,31,31,34,129
4062,32,31,29,22,114
4063,37,35,33,35,140
4064,37,28,31,38,134
4065,39,30,36,27,132
4066,29,39,23,28,119
4067,31,28,30,32,121
4068,22,31,31,38,122
4069,40,29,31,32,132
4070,29,32,37,22,120
4071,34,32,41,34,141
4072,29,31,31,36,127
4073,21,29,39,31,120
4074,43,18,33,30,124
4075,32,33,29,37,131
4076,34,27,32,28,121
4077,30,33,39,27,129
4078,29,30,34,32,125
4079,31,33,26,25,115
4080,35,27,38,29,129
4081,30,28,32,21,111
4082,25,31,28,34,118
4083,27,30,25,26,108
4084,29,32,38,36,135
4085,33,37,31,33,134
4086,30,20,36,27,113
4087,29,26,33,25,113
4088,33,32,30,37,132
4089,39,33,26,24,122
4090,35,30,39,39,143
4091,20,31,37,35,123
4092,31,28,34,18,111
4093,35,36,29,35,135
4094,33,30,23,24,110
4095,33,16,27,32,108
4096,24,32,29,28,113
4097,34,41,24,29,128
4098,17,32,42,31,122
4099,24,38,25,36,123
4100,32,42,30,35,139
4101,37,32,32,35,136
4102,31,33,28,31,123
4103,32,27,36,38,133
4104,24,32,28,32,116
4105,27,37,37,26,127
4106,33,41,38,28,140
4107,28,25,29,38,120
4108,35,28,37,29,129
4109,30,31,33,22,116
4110,24,27,29,26,106
4111,24,28,26,27,105
4112,26,35,36,24,121
4113,33,37,31,26,127
4114,36,40,30,39,145
4115,35,36,22,31,124
4116,34,21,24,35,114
4117,33,31,33,28,125
4118,32,28,33,39,132
4119,28,25,28,35,116
4120,26,38,31,30,125
4121,34,24,29,30,117
4122,32,29,30,39,130
4123,41,34,34,43,152
4124,24,28,40,29,121
4125,33,24,38,14,109
4126,37,35,34,27,133
4127,37,36,28,32,133
4128,34,27,26,33,120
4129,40,33,28,24,125
4130,32,29,33,34,128
4131,25,35,28,25,113
4132,31,33,25,27,116
4133,28,33,35,26,122
4134,29,40,39,36,144
4135,34,29,22,25,110
4136,32,23,36,31,122
4137,28,25,38,27,118
4138,26,26,37,27,116
4139,32,34,29,26,121
4140,24,36,34,33,127
4141,30,23,25,20,98
4142,27,27,32,29,115
4143,21,20,25,34,100
4144,40,31,24,27,122
4145,23,29,41,25,118
4146,42,24,43,31,140
4147,34,29,31,39,133
4148,30,25,38,36,129
4149,37,32,27,23,119
4150,32,38,29,19,118
4151,38,35,32,38,143
4152,23,32,43,42,140
4153,37,28,28,36,129
4154,40,30,29,37,136
4155,34,28,35,33,130
4156,30,26,29,46,131
4157,28,43,23,30,124
4158,36,26,33,38,133
4159,37,32,38,28,135
4160,21,41,28,28,118
4161,29,34,27,34,124
4162,40,30,24,26,120
4163,33,37,20,29,119
4164,29,33,28,30,120
4165,31,30,34,31,126
4166,34,35,33,22,124
4167,31,30,31,23,115
4168,29,24,35,41,129
4169,24,34,37,31,126
4170,26,38,20,27,111
4171,26,41,33,28,128
4172,34,33,29,27,123
4173,31,31,32,34,128
4174,28,26,35,37,126
4175,28,33,24,33,118
4176,29,28,33,30,120
4177,23,31,21,30,105
4178,29,36,39,40,144
4179,28,33,34,42,137
4180,30,26,33,30,119
4181,26,27,29,32,114
4182,24,27,27,29,107
4183,20,31,28,37,116
4184,30,24,34,36,124
4185,35,33,36,28,132
4186,27,29,29,45,130
4187,32,28,24,30,114
4188,27,32,34,34,127
4189,44,34,28,29,135
4190,26,29,27,32,114
4191,28,26,30,41,125
4192,32,24,32,23,111
4193,32,26,31,31,120
4194,30,36,30,31,127
4195,43,30,34,31,138
4196,32,35,38,36,141
4197,25,35,31,31,122
4198,34,32,18,40,124
4199,27,29,34,35,125
4200,34,40,20,30,124
4201,31,29,32,31,123
4202,32,37,27,37,133
4203,35,28,24,27,114
4204,40,26,31,39,136
4205,31,23,40,31,125
4206,34,29,30,27,120
4207,28,41,31,29,129
4208,33,32,34,30,129
4209,40,25,22,29,116
4210,36,36,34,27,133
4211,32,34,33,33,132
4212,40,35,35,27,137
4213,26,34,24,42,126
4214,33,30,38,30,131
4215,25,36,41,20,122
4216,28,39,24,36,127
4217,28,31,42,26,127
4218,24,26,25,24,99
4219,30,22,32,27,111
4220,35,28,41,33,137
4221,36,44,40,44,164
4222,21,36,42,40,139
4223,26,28,27,26,107
4224,39,41,22,27,129
4225,36,24,30,25,115
4226,34,36,25,22,117
4227,31,25,43,37,136
4228,40,30,33,28,131
4229,29,35,23,29,116
4230,26,36,34,25,121
4231,31,29,30,35,125
4232,36,37,27,36,136
4233,26,33,37,30,126
4234,28,25,34,31,118
4235,27,39,23,35,124
4236,24,30,37,30,121
4237,30,34,36,31,131
4238,32,38,25,29,124
4239,31,37,29,28,125
4240,34,32,36,27,129
4241,30,37,26,28,121
4242,31,38,29,30,128
4243,20,34,31,37,122
4244,28,35,28,31,122
4245,30,32,36,34,132
4246,29,30,27,35,121
4247,29,26,37,33,125
4248,26,26,29,27,108
4249,26,32,23,36,117
4250,25,34,38,28,125
4251,30,25,29,28,112
4252,17,25,48,44,134
4253,37,36,33,32,138
4254,33,34,37,36,140
4255,31,29,29,37,126
4256,33,41,40,30,144
4257,26,37,30,29,122
4258,31,31,19,38,119
4259,44,27,24,32,127
4260,35,32,33,27,127
4261,37,35,28,27,127
4262,40,37,39,24,140
4263,21,39,32,36,128
4264,26,41,30,35,132
4265,27,28,28,29,112
4266,32,34,43,28,137
4267,34,26,37,32,129
4268,30,37,32,37,136
4269,32,19,33,34,118
4270,29,39,34,43,145
4271,38,28,30,30,126
4272,43,18,46,32,139
4273,22,32,31,42,127
4274,30,32,36,31,129
4275,29,32,38,28,127
4276,31,30,21,32,114
4277,26,32,25,36,119
4278,28,28,31,19,106
4279,24,28,45,31,128
4280,28,34,26,28,116
4281,27,30,27,31,115
4282,22,32,34,20,108
4283,16,31,24,27,98
4284,35,27,26,27,115
4285,32,22,44,33,131
4286,38,20,31,29,118
4287,35,24,39,22,120
4288,32,22,34,29,117
4289,36,33,25,24,118
4290,26,26,42,41,135
4291,31,27,34,38,130
4292,34,26,31,33,124
4293,32,33,35,38,138
4294,31,32,34,28,125
4295,34,28,36,25,123
4296,30,32,29,28,119
4297,36,27,34,32,129
4298,30,28,29,36,123
4299,30,27,28,32,117
4300,30,22,40,36,128
4301,28,27,34,18,107
4302,30,32,45,44,151
4303,25,37,37,30,129
4304,23,25,25,35,108
4305,35,35,34,25,129
4306,28,25,23,34,110
4307,29,30,22,40,121
4308,28,33,38,26,125
4309,32,27,23,25,107
4310,26,26,22,41,115
4311,25,31,27,27,110
4312,36,26,31,30,123
4313,28,36,22,35,121
4314,29,28,40,29,126
4315,42,37,38,26,143
4316,39,27,22,31,119
4317,36,26,29,36,127
4318,29,38,36,29,132
4319,27,31,35,36,129
4320,34,37,32,26,129
4321,39,34,31,42,146
4322,33,30,35,26,124
4323,45,37,26,27,135
4324,28,33,33,37,131
4325,33,45,33,34,145
4326,31,17,38,34,120
4327,25,26,26,25,102
4328,29,28,31,38,126
4329,24,35,33,25,117
4330,36,34,31,35,136
4331,34,40,38,24,136
4332,35,35,29,28,127
4333,29,41,33,33,136
4334,25,30,37,27,119
4335,26,37,30,38,131
4336,34,32,29,42,137
4337,38,35,32,23,128
4338,29,33,32,37,131
4339,33,27,39,35,134
4340,20,33,33,29,115
4341,34,35,31,28,128
4342,31,37,42,24,134
4343,26,38,26,37,127
4344,25,31,24,30,110
4345,32,32,36,32,132
4346,31,34,24,38,127
4347,32,39,26,32,129
4348,34,31,32,27,124
4349,32,21,36,25,114
4350,35,28,35,32,130
4351,28,30,35,23,116
4352,24,33,31,33,121
4353,24,32,26,28,110
4354,38,29,26,35,128
4355,29,36,24,21,110
4356,37,30,30,27,124
4357,28,40,32,38,138
4358,37,27,25,29,118
4359,33,24,22,36,115
4360,30,36,34,30,130
4361,36,35,28,25,124
4362,37,40,31,26,134
4363,33,22,33,33,121
4364,34,35,23,27,119
4365,31,43,31,27,132
4366,29,27,32,32,120
4367,33,38,40,31,142
4368,34,26,31,25,116
4369,28,31,29,30,118
4370,34,36,34,32,136
4371,29,36,32,25,122
4372,37,30,38,25,130
4373,30,28,22,26,106
4374,26,26,23,33,108
4375,28,26,28,35,117
4376,25,21,31,35,112
4377,38,36,31,32,137
4378,28,34,30,33,125
4379,23,41,32,27,123
4380,20,35,30,33,118
4381,19,21,39,30,109
4382,24,35,28,42,129
4383,36,23,48,31,138
4384,36,27,25,31,119
4385,37,32,31,30,130
4386,35,26,35,29,125
4387,31,39,36,30,136
4388,19,38,23,37,117
4389,28,41,36,22,127
4390,29,31,38,31,129
4391,26,40,29,30,125
4392,32,23,30,41,126
4393,25,43,33,28,129
4394,30,28,26,33,117
4395,37,21,42,28,128
4396,29,33,26,26,114
4397,27,31,31,26,115
4398,26,39,25,36,126
4399,36,40,28,33,137
4400,28,27,22,39,116
4401,29,26,25,31,111
4402,31,28,31,25,115
4403,26,27,34,32,119
4404,40,36,25,31,132
4405,46,27,22,36,131
4406,24,37,29,32,122
4407,26,49,22,36,133
4408,39,36,32,42,149
4409,30,32,24,28,114
4410,33,26,39,29,127
4411,32,41,32,41,146
4412,35,30,34,27,126
4413,33,37,31,37,138
4414,28,34,39,44,145
4415,34,37,33,25,129
4416,26,22,32,39,119
4417,29,25,38,24,116
4418,24,30,36,41,131
4419,30,28,24,31,113
4420,29,31,33,38,131
4421,42,27,35,36,140
4422,35,40,36,37,148
4423,27,33,27,26,113
4424,33,32,41,25,131
4425,31,39,26,34,130
4426,28,28,29,37,122
4427,29,29,30,25,113
4428,33,37,25,36,131
4429,40,35,24,28,127
4430,28,28,32,35,123
4431,37,33,24,27,121
4432,31,29,30,27,117
4433,42,27,30,32,131
4434,27,26,36,22,111
4435,33,21,43,32,129
4436,29,26,24,34,113
4437,33,24,35,30,122
4438,32,32,26,28,118
4439,29,31,27,30,117
4440,17,29,27,24,97
4441,31,33,32,19,115
4442,23,34,23,26,106
4443,28,35,23,25,111
4444,27,29,34,29,119
4445,33,29,36,27,125
4446,35,27,36,33,131
4447,30,32,39,28,129
4448,29,29,35,39,132
4449,29,34,28,23,114
4450,30,26,45,31,132
4451,28,32,33,33,126
4452,28,27,25,35,115
4453,24,27,35,39,125
4454,40,30,26,29,125
4455,34,38,25,22,119
4456,30,30,23,33,116
4457,27,42,24,42,135
4458,35,36,28,40,139
4459,21,36,29,30,116
4460,30,30,24,26,110
4461,37,36,22,29,124
4462,32,42,33,35,142
4463,32,27,28,35,122
4464,18,28,39,32,117
4465,25,38,33,37,133
4466,31,35,33,27,126
4467,27,33,32,34,126
4468,42,30,28,30,130
4469,30,35,25,28,118
4470,32,30,28,31,121
4471,33,33,39,31,136
4472,37,38,27,28,130
4473,28,33,26,34,121
4474,47,28,33,23,131
4475,41,28,33,19,121
4476,40,26,26,30,122
4477,31,36,30,32,129
4478,28,35,31,28,122
4479,35,30,26,28,119
4480,26,23,24,34,107
4481,38,33,23,35,129
4482,32,30,38,36,136
4483,31,33,31,32,127
4484,29,36,40,23,128
4485,24,40,27,35,126
4486,36,27,37,37,137
4487,31,39,30,28,128
4488,38,21,33,32,124
4489,42,23,31,31,127
4490,32,34,32,33,131
4491,36,42,27,43,148
4492,29,16,28,27,100
4493,29,27,20,22,98
4494,28,31,36,32,127
4495,30,29,29,27,115
4496,34,31,26,33,124
4497,35,22,37,22,116
4498,30,32,25,33,120
4499,33,33,27,29,122
4500,30,36,32,29,127
4501,34,32,26,20,112
4502,39,28,31,40,138
4503,32,26,32,32,122
4504,31,31,29,27,118
4505,27,29,34,40,130
4506,26,28,31,37,122
4507,34,30,31,39,134
4508,24,42,29,30,125
4509,29,29,39,45,142
4510,37,30,28,28,123
4511,39,32,25,29,125
4512,29,31,36,35,131
4513,27,34,31,43,135
4514,33,29,33,33,128
4515,40,29,38,23,130
4516,27,34,33,26,120
4517,33,27,30,29,119
4518,30,27,37,41,135
4519,36,31,32,31,130
4520,37,36,29,23,125
4521,35,39,27,29,130
4522,27,35,33,30,125
4523,30,38,33,29,130
4524,36,28,29,34,127
4525,31,26,22,35,114
4526,34,28,32,22,116
4527,27,33,27,31,118
4528,30,31,23,34,118
4529,28,28,30,38,124
4530,27,25,24,28,104
4531,39,31,32,19,121
4532,33,25,31,31,120
4533,30,31,28,43,132
4534,28,38,34,32,132
4535,33,35,25,23,116
4536,36,25,33,46,140
4537,29,23,32,33,117
4538,33,29,39,27,128
4539,34,31,27,34,126
4540,25,35,29,36,125
4541,24,34,32,28,118
4542,36,32,28,39,135
4543,26,35,39,34,134
4544,40,27,37,33,137
4545,31,42,36,23,132
4546,32,29,38,35,134
4547,31,34,39,24,128
4548,50,24,27,26,127
4549,43,22,23,42,130
4550,33,24,31,31,119
4551,31,38,28,39,136
4552,19,42,35,25,121
4553,25,25,34,38,122
4554,29,37,29,29,124
4555,32,29,30,31,122
4556,29,41,31,34,135
4557,31,29,31,26,117
4558,19,26,36,28,109
4559,35,29,36,33,133
4560,26,24,41,29,120
4561,35,42,29,34,140
4562,39,35,38,36,148
4563,37,26,30,26,119
4564,34,29,19,21,103
4565,25,32,39,29,125
4566,32,31,37,26,126
4567,31,28,40,44,143
4568,38,26,37,33,134
4569,39,39,34,33,145
4570,35,28,24,36,123
4571,32,37,32,30,131
4572,29,29,28,36,122
4573,34,31,37,33,135
4574,39,33,30,28,130
4575,31,24,36,28,119
4576,27,32,26,31,116
4577,38,25,34,41,138
4578,37,36,32,29,134
4579,29,33,30,39,131
4580,33,33,33,37,136
4581,35,40,22,30,127
4582,37,28,33,24,122
4583,40,31,40,35,146
4584,29,30,24,31,114
4585,29,36,27,30,122
4586,30,28,25,28,111
4587,46,18,25,27,116
4588,30,34,19,33,116
4589,28,34,42,27,131
4590,35,25,37,43,140
4591,25,35,24,25,109
4592,28,26,29,39,122
4593,31,35,15,35,116
4594,36,33,37,25,131
4595,31,34,30,26,121
4596,32,26,38,34,130
4597,24,31,27,19,101
4598,29,35,26,27,117
4599,35,38,29,25,127
4600,30,34,32,35,131
4601,22,29,32,24,107
4602,24,32,29,30,115
4603,29,35,32,28,124
4604,23,22,34,28,107
4605,42,42,31,21,136
4606,36,33,39,38,146
4607,38,28,29,35,130
4608,27,28,35,26,116
4609,21,38,40,39,138
4610,25,44,19,32,120
4611,33,28,22,36,119
4612,32,34,38,32,136
4613,20,26,32,34,112
4614,27,25,41,26,119
4615,28,31,33,30,122
4616,38,32,28,36,134
4617,19,43,25,37,124
4618,30,37,28,36,131
4619,31,43,42,25,141
4620,26,34,42,30,132
4621,40,25,36,29,130
4622,19,36,34,43,132
4623,37,26,27,23,113
4624,31,26,30,26,113
4625,23,39,29,32,123
4626,26,39,34,38,137
4627,38,29,31,33,131
4628,35,22,34,24,115
4629,32,22,45,30,129
4630,32,34,23,31,120
4631,32,38,33,26,129
4632,38,25,30,37,130
4633,32,27,30,31,120
4634,22,31,37,38,128
4635,22,28,29,36,115
4636,26,25,38,42,131
4637,32,28,28,42,130
4638,33,31,39,27,130
4639,29,26,23,38,116
4640,41,35,31,33,140
4641,25,31,44,30,130
4642,27,18,33,30,108
4643,32,33,26,36,127
4644,30,33,24,41,128
4645,28,34,35,31,128
4646,37,29,35,28,129
4647,31,32,31,43,137
4648,24,33,23,40,120
4649,34,28,39,27,128
4650,35,33,36,44,148
4651,38,29,35,20,122
4652,31,35,27,31,124
4653,30,25,28,37,120
4654,20,42,32,22,116
4655,22,29,30,29,110
4656,33,27,35,29,124
4657,38,33,39,34,144
4658,30,31,29,31,121
4659,32,31,38,24,125
4660,31,28,20,22,101
4661,27,29,39,36,131
4662,28,34,33,26,121
4663,37,35,33,31,136
4664,27,21,28,43,119
4665,31,33,27,32,123
4666,33,35,41,31,140
4667,35,25,35,27,122
4668,31,23,35,20,109
4669,33,32,37,23,125
4670,25,28,32,32,117
4671,28,30,29,29,116
4672,35,27,38,24,124
4673,37,36,20,29,122
4674,32,25,32,37,126
4675,37,31,40,40,148
4676,27,26,30,35,118
4677,28,33,32,26,119
4678,33,39,26,33,131
4679,32,28,35,29,124
4680,35,28,38,32,133
4681,27,33,18,50,128
4682,23,37,28,35,123
4683,31,33,27,34,125
4684,29,34,28,37,128
4685,38,33,26,39,136
4686,26,31,23,35,115
4687,27,36,45,38,146
4688,41,24,39,29,133
4689,32,37,28,43,140
4690,21,33,24,28,106
4691,34,35,25,31,125
4692,24,32,24,23,103
4693,22,37,28,33,120
4694,42,19,28,30,119
4695,33,36,21,31,121
4696,29,37,28,34,128
4697,40,34,44,24,142
4698,26,34,23,32,115
4699,32,27,34,35,128
4700,29,24,31,31,115
4701,31,29,34,45,139
4702,44,33,42,35,154
4703,30,39,29,31,129
4704,23,17,39,35,114
4705,33,28,30,28,119
4706,36,40,26,30,132
4707,23,36,29,44,132
4708,29,28,37,29,123
4709,36,23,23,30,112
4710,32,31,28,39,130
4711,47,30,30,31,138
4712,46,22,35,26,129
4713,30,27,34,20,111
4714,33,33,33,31,130
4715,27,37,41,29,134
4716,32,43,27,35,137
4717,25,36,25,28,114
4718,36,26,29,33,124
4719,32,32,35,36,135
4720,29,27,31,39,126
4721,32,24,25,40,121
4722,32,28,29,33,122
4723,34,33,27,28,122
4724,37,28,33,39,137
4725,19,29,27,40,115
4726,39,32,34,33,138
4727,23,29,25,29,106
4728,40,38,30,34,142
4729,27,30,29,40,126
4730,32,40,31,32,135
4731,36,38,32,32,138
4732,30,27,30,31,118
4733,32,25,31,32,120
4734,37,37,32,32,138
4735,30,27,37,33,127
4736,27,39,30,31,127
4737,29,27,42,41,139
4738,25,29,31,42,127
4739,32,30,27,33,122
4740,32,29,38,31,130
4741,27,29,28,34,118
4742,32,26,27,33,118
4743,33,27,37,37,134
4744,17,24,36,35,112
4745,29,39,24,39,131
4746,30,21,34,45,130
4747,39,41,28,27,135
4748,26,29,42,31,128
4749,35,26,33,34,128
4750,34,25,43,25,127
4751,27,25,30,31,113
4752,32,28,40,35,135
4753,31,25,33,34,123
4754,29,33,38,27,127
4755,35,31,46,30,142
4756,34,42,26,23,125
4757,30,37,33,20,120
4758,28,43,27,24,122
4759,33,30,31,38,132
4760,33,40,36,27,136
4761,25,37,36,33,131
4762,37,28,36,27,128
4763,31,29,20,32,112
4764,31,27,28,19,105
4765,34,35,38,29,136
4766,31,27,30,28,116
4767,29,33,23,34,119
4768,29,25,35,28,117
4769,31,32,38,34,135
4770,27,31,48,40,146
4771,29,29,28,34,120
4772,36,23,41,36,136
4773,23,36,33,28,120
4774,28,32,32,29,121
4775,30,27,29,34,120
4776,29,26,35,33,123
4777,35,26,31,39,131
4778,39,34,35,30,138
4779,25,26,31,26,108
4780,28,27,33,44,132
4781,35,20,34,28,117
4782,24,32,34,31,121
4783,28,37,24,24,113
4784,39,33,30,21,123
4785,23,30,33,32,118
4786,31,34,37,30,132
4787,33,30,27,28,118
4788,28,29,31,27,115
4789,27,30,31,28,116
4790,32,35,27,43,137
4791,39,31,29,31,130
4792,37,23,31,39,130
4793,35,32,31,33,131
4794,28,27,38,31,124
4795,33,27,33,23,116
4796,32,37,28,38,135
4797,35,36,31,29,131
4798,34,27,21,27,109
4799,37,37,38,24,136
4800,34,32,33,22,121
4801,26,31,34,30,121
4802,25,30,31,24,110
4803,38,28,30,34,130
4804,30,29,46,29,134
4805,27,42,25,23,117
4806,27,32,27,26,112
4807,32,24,41,34,131
4808,34,27,34,33,128
4809,32,37,40,30,139
4810,26,28,29,28,111
4811,32,34,36,42,144
4812,29,40,37,27,133
4813,33,30,27,27,117
4814,30,32,25,19,106
4815,39,30,32,36,137
4816,33,25,27,37,122
4817,24,27,27,25,103
4818,35,34,20,32,121
4819,35,30,36,44,145
4820,30,28,38,26,122
4821,31,32,25,30,118
4822,35,37,23,25,120
4823,29,33,31,23,116
4824,41,40,31,25,137
4825,30,39,34,27,130
4826,30,39,26,34,129
4827,24,24,32,30,110
4828,31,40,37,26,134
4829,32,22,23,36,113
4830,27,17,26,30,100
4831,31,24,36,33,124
4832,29,28,30,28,115
4833,25,29,24,29,107
4834,36,30,27,24,117
4835,24,26,35,33,118
4836,40,33,24,36,133
4837,33,33,26,36,128
4838,22,23,39,32,116
4839,39,24,29,24,116
4840,25,33,33,32,123
4841,28,31,23,33,115
4842,44,22,39,28,133
4843,33,30,33,21,117
4844,34,26,32,32,124
4845,32,28,39,22,121
4846,26,19,38,27,110
4847,14,26,30,31,101
4848,42,30,21,27,120
4849,36,28,30,20,114
4850,30,26,35,29,120
4851,28,26,40,21,115
4852,24,29,27,40,120
4853,27,32,32,33,124
4854,27,30,30,33,120
4855,37,26,32,31,126
4856,26,28,29,34,117
4857,36,24,33,29,122
4858,44,36,36,19,135
4859,38,27,35,29,129
4860,35,31,25,34,125
4861,30,35,33,26,124
4862,29,39,30,33,131
4863,39,23,33,32,127
4864,37,33,29,27,126
4865,16,28,33,28,105
4866,30,39,30,40,139
4867,30,18,37,29,114
4868,32,22,30,28,112
4869,26,35,22,22,105
4870,23,35,24,28,110
4871,25,36,30,45,136
4872,28,32,39,36,135
4873,35,35,35,30,135
4874,23,34,29,29,115
4875,19,31,32,49,131
4876,27,35,39,38,139
4877,38,23,28,29,118
4878,28,32,30,48,138
4879,39,41,25,29,134
4880,28,35,25,36,124
4881,38,30,32,28,128
4882,32,34,32,32,130
4883,43,36,28,31,138
4884,25,24,25,28,102
4885,24,32,27,24,107
4886,36,33,29,21,119
4887,40,28,27,29,124
4888,29,29,35,30,123
4889,31,30,28,33,122
4890,27,30,32,21,110
4891,35,32,24,37,128
4892,26,35,23,28,112
4893,34,21,34,20,109
4894,33,32,25,27,117
4895,22,32,33,34,121
4896,34,27,35,29,125
4897,36,35,33,29,133
4898,36,24,32,35,127
4899,31,28,36,30,125
4900,25,38,19,30,112
4901,24,37,32,34,127
4902,42,31,28,35,136
4903,39,29,30,25,123
4904,39,30,29,32,130
4905,24,32,27,27,110
4906,36,28,31,33,128
4907,36,34,30,29,129
4908,41,27,36,22,126
4909,31,33,26,25,115
4910,28,35,36,30,129
4911,25,36,27,37,125
4912,34,38,28,34,134
4913,33,30,30,24,117
4914,36,28,27,35,126
4915,33,31,21,26,111
4916,27,23,28,30,108
4917,32,29,32,30,123
4918,34,33,24,24,115
4919,25,30,32,37,124
4920,23,25,31,31,110
4921,26,40,37,35,138
4922,22,34,29,32,117
4923,28,28,37,32,125
4924,31,31,37,26,125
4925,33,30,36,30,129
4926,35,40,25,22,122
4927,29,27,35,35,126
4928,30,33,28,28,119
4929,33,20,36,44,133
4930,32,31,21,22,106
4931,30,32,32,34,128
4932,29,29,41,35,134
4933,34,29,22,30,115
4934,22,42,39,29,132
4935,25,34,40,25,124
4936,27,33,25,38,123
4937,33,29,25,40,127
4938,38,27,28,32,125
4939,28,28,21,26,103
4940,32,21,36,30,119
4941,38,34,35,32,139
4942,35,35,34,27,131
4943,36,38,28,30,132
4944,33,34,33,32,132
4945,24,23,25,38,110
4946,38,19,28,39,124
4947,33,36,33,23,125
4948,27,26,26,34,113
4949,34,28,27,34,123
4950,27,32,29,32,120
4951,36,32,27,22,117
4952,36,37,26,37,136
4953,31,30,37,25,123
4954,25,37,36,26,124
4955,32,29,30,24,115
4956,23,26,35,35,119
4957,28,26,29,31,114
4958,29,24,39,27,119
4959,33,34,20,31,118
4960,31,32,23,34,120
4961,36,39,40,33,148
4962,29,34,37,35,135
4963,36,35,28,24,123
4964,31,30,32,29,122
4965,29,32,41,29,131
4966,25,24,31,33,113
4967,32,43,27,29,131
4968,29,25,28,35,117
4969,30,31,35,34,130
4970,23,27,34,34,118
4971,33,31,26,35,125
4972,29,41,45,36,151
4973,33,32,32,26,123
4974,32,38,26,26,122
4975,33,26,21,33,113
4976,26,24,32,30,112
4977,42,27,35,35,139
4978,26,32,29,34,121
4979,34,28,27,31,120
4980,21,37,36,29,123
4981,32,28,34,37,131
4982,27,37,27,33,124
4983,39,33,36,26,134
4984,17,30,34,32,113
4985,40,29,35,39,143
4986,28,37,29,31,125
4987,36,23,33,24,116
4988,35,30,32,31,128
4989,37,37,31,42,147
4990,38,28,28,24,118
4991,33,37,28,26,124
4992,35,31,38,25,129
4993,27,35,35,22,119
4994,28,26,30,28,112
4995,28,27,37,22,114
4996,35,29,38,35,137
4997,34,33,41,29,137
4998,39,27,38,32,136
4999,35,28,32,31,126
5000,26,29,29,22,106
5001,26,35,38,28,127
5002,37,26,40,35,138
5003,42,36,28,32,138
5004,36,40,32,33,141
5005,37,30,30,39,136
5006,28,22,26,41,117
5007,29,34,27,36,126
5008,32,30,29,40,131
5009,33,29,22,39,123
5010,30,32,36,34,132
5011,28,39,32,34,133
5012,36,33,28,29,126
5013,32,28,36,29,125
5014,31,44,30,33,138
5015,26,23,40,26,115
5016,37,29,27,24,117
5017,35,21,31,43,130
5018,29,43,35,28,135
5019,27,22,30,34,113
5020,46,25,30,43,144
5021,31,31,39,29,130
5022,26,38,34,32,130
5023,27,36,43,28,134
5024,32,29,24,32,117
5025,28,32,32,33,125
5026,24,35,31,32,122
5027,40,25,36,34,135
5028,33,36,34,29,132
5029,37,20,25,40,122
5030,33,34,30,34,131
5031,31,35,34,42,142
5032,31,32,42,22,127
5033,24,32,33,29,118
5034,35,28,30,33,126
5035,33,38,33,33,137
5036,35,34,33,18,120
5037,29,35,25,32,121
5038,37,34,35,35,141
5039,42,29,31,35,137
5040,38,29,31,32,130
5041,32,31,41,29,133
5042,33,29,29,27,118
5043,24,31,36,38,129
5044,39,24,31,35,129
5045,27,30,34,28,119
5046,29,32,32,42,135
5047,31,33,23,31,118
5048,23,22,26,35,106
5049,31,39,29,30,129
5050,25,26,31,27,109
5051,28,25,39,33,125
5052,26,37,33,30,126
5053,30,40,34,41,145
5054,36,32,33,25,126
5055,31,41,24,28,124
5056,36,30,28,36,130
5057,25,28,37,38,128
5058,23,33,31,30,117
5059,51,19,30,28,128
5060,37,25,31,30,123
5061,35,32,33,30,130
5062,33,27,23,38,121
5063,30,27,32,33,122
5064,35,31,21,31,118
5065,33,31,33,32,129
5066,33,28,32,23,116
5067,30,28,28,42,128
5068,31,35,38,36,140
5069,29,32,37,31,129
5070,31,24,48,32,135
5071,28,25,29,42,124
5072,29,27,23,38,117
5073,32,23,28,27,110
5074,43,32,35,27,137
5075,30,22,26,29,107
5076,29,30,28,36,123
5077,38,51,33,35,157
5078,26,40,31,30,127
5079,20,40,38,34,132
5080,33,42,36,26,137
5081,29,27,38,31,125
5082,22,32,29,23,106
5083,36,17,29,35,117
5084,31,31,34,38,134
5085,30,31,22,31,114
5086,31,35,36,30,132
5087,35,29,29,33,126
5088,36,29,42,36,143
5089,30,37,27,32,126
5090,32,26,31,29,118
5091,20,23,31,43,117
5092,26,26,37,23,112
5093,30,36,44,34,144
5094,41,32,26,34,133
5095,26,29,25,43,123
5096,35,32,36,33,136
5097,31,27,28,24,110
5098,26,26,36,35,123
5099,22,39,33,31,125
5100,25,27,28,36,116
5101,37,29,40,32,138
5102,31,38,35,33,137
5103,24,33,37,28,122
5104,27,30,25,42,124
5105,33,45,38,23,139
5106,27,38,27,29,121
5107,34,26,40,33,133
5108,30,31,35,30,126
5109,33,27,38,25,123
5110,36,35,36,26,133
5111,34,35,24,35,128
5112,37,31,32,29,129
5113,37,26,23,19,105
5114,25,38,35,30,128
5115,29,35,33,27,124
5116,28,23,40,30,121
5117,36,29,39,36,140
5118,25,29,32,26,112
5119,27,33,36,42,138
5120,39,40,35,17,131
5121,31,26,35,25,117
5122,37,32,28,39,136
5123,36,33,22,37,128
5124,30,31,32,22,115
5125,33,39,39,19,130
5126,32,39,31,33,135
5127,28,37,26,39,130
5128,29,27,28,28,112
5129,23,47,23,25,118
5130,31,33,29,29,122
5131,34,23,38,21,116
5132,38,28,32,27,125
5133,29,26,29,30,114
5134,48,36,24,26,134
5135,28,35,34,33,130
5136,43,41,41,26,151
5137,40,31,37,30,138
5138,25,27,28,37,117
5139,40,26,27,29,122
5140,21,39,21,35,116
5141,33,39,22,27,121
5142,32,30,37,30,129
5143,36,19,39,29,123
5144,32,38,38,28,136
5145,37,19,33,26,115
5146,35,30,39,21,125
5147,30,36,36,29,131
5148,31,29,37,43,140
5149,39,34,38,36,147
5150,28,31,31,28,118
5151,39,24,23,32,118
5152,38,27,34,36,135
5153,25,27,34,31,117
5154,32,33,33,26,124
5155,28,28,38,26,120
5156,33,23,34,32,122
5157,29,22,38,39,128
5158,32,22,38,28,120
5159,32,33,29,37,131
5160,37,37,38,23,135
5161,29,32,29,31,121
5162,34,33,29,26,122
5163,28,26,31,38,123
5164,36,28,27,31,122
5165,25,35,35,32,127
5166,32,41,31,29,133
5167,32,50,31,33,146
5168,31,22,26,31,110
5169,27,29,29,31,116
5170,32,29,37,29,127
5171,34,30,29,36,129
5172,36,34,31,36,137
5173,35,38,29,37,139
5174,24,24,29,23,100
5175,39,28,33,23,123
5176,37,32,37,41,147
5177,34,27,28,30,119
5178,36,26,29,32,123
5179,33,24,34,32,123
5180,38,33,33,33,137
5181,32,33,27,21,113
5182,35,29,34,28,126
5183,26,27,32,27,112
5184,33,25,28,33,119
5185,29,37,25,33,124
5186,29,30,28,19,106
5187,31,32,32,26,121
5188,29,34,21,32,116
5189,36,26,40,26,128
5190,32,18,30,36,116
5191,23,30,27,28,108
5192,33,29,30,32,124
5193,22,28,30,25,105
5194,34,35,28,18,115
5195,34,37,24,24,119
5196,45,27,28,33,133
5197,35,26,32,38,131
5198,28,35,34,20,117
5199,37,31,30,31,129
5200,29,43,34,36,142
5201,24,28,26,29,107
5202,29,31,42,27,129
5203,24,30,34,32,120
5204,24,29,39,25,117
5205,35,25,34,30,124
5206,28,33,30,29,120
5207,44,27,32,27,130
5208,41,27,37,33,138
5209,28,31,28,36,123
5210,38,26,35,26,125
5211,32,26,35,35,128
5212,31,27,26,29,113
5213,30,37,39,36,142
5214,25,31,30,36,122
5215,30,26,33,33,122
5216,33,33,23,42,131
5217,35,27,25,31,118
5218,25,34,46,29,134
5219,32,30,22,20,104
5220,32,35,38,34,139
5221,28,32,34,25,119
5222,33,26,30,26,115
5223,31,27,30,25,113
5224,30,35,28,33,126
5225,32,30,31,38,131
5226,30,34,30,30,124
5227,37,25,28,27,117
5228,33,26,29,42,130
5229,41,27,23,34,125
5230,31,22,28,20,101
5231,32,23,38,45,138
5232,35,32,34,22,123
5233,37,24,26,26,113
5234,36,34,39,34,143
5235,26,24,35,32,117
5236,34,26,33,41,134
5237,37,37,21,32,127
5238,39,29,39,18,125
5239,23,28,32,33,116
5240,32,31,36,34,133
5241,21,30,30,33,114
5242,30,26,19,35,110
5243,27,42,26,38,133
5244,18,22,40,44,124
5245,34,33,28,36,131
5246,38,30,40,22,130
5247,30,36,27,44,137
5248,32,32,34,32,130
5249,34,29,35,34,132
5250,28,32,36,35,131
5251,29,25,41,32,127
5252,26,32,30,28,116
5253,29,41,28,32,130
5254,25,35,39,33,132
5255,35,35,36,24,130
5256,21,29,23,38,111
5257,22,37,30,30,119
5258,39,36,31,24,130
5259,34,35,22,27,118
5260,34,37,34,37,142
5261,28,36,27,37,128
5262,39,29,24,41,133
5263,43,40,35,33,151
5264,34,29,30,42,135
5265,32,34,37,33,136
5266,29,28,26,41,124
5267,38,42,30,34,144
5268,37,29,29,30,125
5269,23,32,38,31,124
5270,31,29,34,29,123
5271,22,36,26,35,119
5272,30,24,34,40,128
5273,34,26,30,37,127
5274,31,31,29,37,128
5275,29,31,33,29,122
5276,33,26,37,28,124
5277,33,31,37,31,132
5278,30,43,38,31,142
5279,29,30,28,29,116
5280,21,32,33,35,121
5281,27,38,33,32,130
5282,29,25,24,34,112
5283,22,32,31,24,109
5284,30,34,34,34,132
5285,38,28,30,32,128
5286,31,35,31,26,123
5287,36,32,27,23,118
5288,20,27,29,26,102
5289,44,32,33,27,136
5290,30,33,26,19,108
5291,25,29,41,40,135
5292,38,31,33,20,122
5293,24,19,36,29,108
5294,32,30,28,34,124
5295,41,27,38,40,146
5296,28,29,33,35,125
5297,39,31,37,31,138
5298,19,23,40,42,124
5299,32,28,27,24,111
5300,40,33,42,33,148
5301,27,31,33,30,121
5302,39,35,24,31,129
5303,26,26,31,27,110
5304,35,15,31,40,121
5305,24,28,41,26,119
5306,31,27,35,27,120
5307,37,32,33,25,127
5308,28,42,40,33,143
5309,33,31,24,30,118
5310,28,20,18,31,97
5311,37,30,36,34,137
5312,27,22,24,39,112
5313,36,35,34,34,139
5314,36,26,31,19,112
5315,31,30,35,35,131
5316,32,30,24,25,111
5317,37,39,33,38,147
5318,32,29,36,32,129
5319,30,29,26,37,122
5320,28,21,24,22,95
5321,27,36,28,25,116
5322,15,35,40,31,121
5323,26,25,31,32,114
5324,23,36,22,34,115
5325,40,36,39,36,151
5326,37,22,29,34,122
5327,25,29,23,31,108
5328,39,21,28,36,124
5329,32,34,24,28,118
5330,24,38,25,28,115
5331,29,39,33,27,128
5332,35,30,33,30,128
5333,35,40,25,40,140
5334,23,25,44,31,123
5335,34,28,34,31,127
5336,28,22,24,32,106
5337,31,28,26,30,115
5338,34,37,34,29,134
5339,35,24,32,27,118
5340,28,26,39,26,119
5341,32,21,32,28,113
5342,29,29,37,24,119
5343,29,33,27,33,122
5344,32,23,30,25,110
5345,43,41,34,35,153
5346,35,25,29,23,112
5347,23,28,36,30,117
5348,28,22,39,26,115
5349,29,26,26,39,120
5350,26,39,35,20,120
5351,34,31,43,31,139
5352,43,28,32,30,133
5353,26,36,30,37,129
5354,31,30,40,38,139
5355,39,36,27,19,121
5356,27,27,24,22,100
5357,31,34,29,32,126
5358,39,35,26,30,130
5359,24,33,34,32,123
5360,41,32,35,32,140
5361,32,26,30,26,114
5362,25,32,35,40,132
5363,34,27,41,18,120
5364,27,30,48,34,139
5365,24,30,37,32,123
5366,27,29,30,43,129
5367,33,20,32,31,116
5368,37,36,32,39,144
5369,46,34,27,24,131
5370,35,28,32,38,133
5371,35,32,39,24,130
5372,33,28,34,35,130
5373,36,27,24,24,111
5374,34,30,33,26,123
5375,31,32,33,36,132
5376,33,31,41,24,129
5377,32,35,31,29,127
5378,31,34,31,24,120
5379,29,30,31,39,129
5380,36,33,27,40,136
5381,30,38,37,38,143
5382,28,26,32,28,114
5383,35,33,26,39,133
5384,41,36,34,36,147
5385,30,33,39,32,134
5386,29,28,26,31,114
5387,19,35,25,29,108
5388,23,39,29,34,125
5389,28,36,43,31,138
5390,36,32,27,35,130
5391,32,33,31,24,120
5392,31,30,35,26,122
5393,21,39,26,31,117
5394,35,34,32,31,132
5395,27,31,40,32,130
5396,29,33,35,42,139
5397,36,34,23,20,113
5398,26,38,27,27,118
5399,39,23,30,22,114
5400,29,19,29,40,117
5401,32,22,26,26,106
5402,34,29,29,34,126
5403,34,29,27,35,125
5404,33,29,34,29,125
5405,36,25,35,20,116
5406,25,33,39,22,119
5407,26,29,34,27,116
5408,34,36,31,26,127
5409,28,30,31,27,116
5410,31,27,36,29,123
5411,49,31,27,26,133
5412,31,27,21,35,114
5413,31,42,39,23,135
5414,34,28,24,22,108
5415,42,39,26,44,151
5416,26,32,41,36,135
5417,30,25,38,25,118
5418,29,33,33,34,129
5419,27,36,31,31,125
5420,26,34,27,25,112
5421,32,24,40,30,126
5422,27,35,25,34,121
5423,28,31,29,35,123
5424,35,31,21,28,115
5425,32,36,35,31,134
5426,24,34,29,24,111
5427,40,33,31,23,127
5428,36,25,24,25,110
5429,39,39,26,36,140
5430,33,25,36,30,124
5431,30,28,35,28,121
5432,34,28,36,33,131
5433,24,26,37,32,119
5434,21,28,32,45,126
5435,36,36,34,28,134
5436,26,27,26,37,116
5437,29,34,31,33,127
5438,33,31,25,41,130
5439,30,26,20,32,108
5440,37,32,29,39,137
5441,33,30,42,37,142
5442,25,34,28,34,121
5443,35,27,25,39,126
5444,30,30,33,24,117
5445,34,44,37,35,150
5446,32,37,31,27,127
5447,33,34,30,29,126
5448,26,24,33,29,112
5449,27,31,37,32,127
5450,30,34,25,33,122
5451,34,35,34,23,126
5452,37,33,30,35,135
5453,38,32,38,24,132
5454,32,35,20,37,124
5455,38,26,30,31,125
5456,23,23,38,27,111
5457,27,39,41,36,143
5458,32,35,27,32,126
5459,35,25,27,38,125
5460,29,36,47,29,141
5461,40,33,26,28,127
5462,36,30,29,28,123
5463,20,34,36,40,130
5464,26,33,25,19,103
5465,29,33,30,39,131
5466,32,32,28,30,122
5467,32,30,29,28,119
5468,33,21,28,33,115
5469,32,27,33,34,126
5470,33,30,29,32,124
5471,17,31,27,30,105
5472,33,37,32,20,122
5473,28,31,37,30,126
5474,23,26,23,26,98
5475,32,36,29,40,137
5476,36,29,34,31,130
5477,31,34,36,30,131
5478,37,32,26,32,127
5479,39,28,32,29,128
5480,36,41,38,29,144
5481,27,40,33,34,134
5482,40,32,22,34,128
5483,30,23,26,23,102
5484,28,31,35,40,134
5485,39,26,30,30,125
5486,32,34,31,29,126
5487,24,27,37,34,122
5488,29,26,33,31,119
5489,34,35,34,24,127
5490,33,28,39,30,130
5491,36,32,28,34,130
5492,36,32,28,29,125
5493,34,27,22,37,120
5494,28,30,30,44,132
5495,24,26,34,20,104
5496,33,32,30,30,125
5497,42,26,39,31,138
5498,36,28,35,27,126
5499,34,25,33,30,122
5500,30,29,24,28,111
5501,38,34,29,40,141
5502,25,37,36,27,125
5503,28,33,28,26,115
5504,32,30,37,39,138
5505,30,36,22,46,134
5506,38,32,38,35,143
5507,33,33,29,30,125
5508,32,32,36,31,131
5509,30,39,35,33,137
5510,22,27,30,34,113
5511,33,28,31,23,115
5512,28,29,26,36,119
5513,27,31,36,39,133
5514,29,24,38,30,121
5515,34,25,34,27,120
5516,39,25,39,28,131
5517,35,35,41,17,128
5518,32,24,34,40,130
5519,24,24,28,30,106
5520,26,34,27,33,120
5521,29,37,31,31,128
5522,33,36,28,34,131
5523,49,26,32,21,128
5524,36,23,32,29,120
5525,25,29,29,25,108
5526,21,28,37,38,124
5527,29,29,31,30,119
5528,28,35,41,25,129
5529,21,26,33,31,111
5530,34,33,32,23,122
5531,32,23,30,35,120
5532,26,31,26,31,114
5533,29,30,30,28,117
5534,21,22,32,28,103
5535,32,30,42,28,132
5536,37,27,30,25,119
5537,29,25,38,35,127
5538,30,27,34,35,126
5539,30,33,26,37,126
5540,25,33,27,36,121
5541,32,32,23,35,122
5542,33,25,39,42,139
5543,32,30,32,26,120
5544,35,32,26,34,127
5545,36,39,24,32,131
5546,29,38,28,26,121
5547,36,29,31,29,125
5548,23,25,28,29,105
5549,33,26,28,30,117
5550,34,36,32,26,128
5551,30,27,31,34,122
5552,30,27,34,34,125
5553,33,28,30,36,127
5554,38,36,35,29,138
5555,33,35,30,25,123
5556,38,33,30,30,131
5557,29,39,34,28,130
5558,35,28,37,44,144
5559,30,29,29,23,111
5560,36,28,30,43,137
5561,35,32,26,33,126
5562,37,29,37,32,135
5563,32,37,23,43,135
5564,29,39,29,26,123
5565,28,37,44,31,140
5566,26,33,26,34,119
5567,24,32,33,34,123
5568,35,35,39,34,143
5569,33,25,28,27,113
5570,25,32,25,26,108
5571,32,26,27,29,114
5572,19,24,24,22,89
5573,22,24,33,36,115
5574,30,43,38,29,140
5575,32,34,34,27,127
5576,40,34,28,29,131
5577,39,36,28,24,127
5578,34,25,27,44,130
5579,35,32,25,28,120
5580,31,29,37,31,128
5581,29,30,30,24,113
5582,32,36,30,37,135
5583,24,39,25,39,127
5584,26,36,24,35,121
5585,27,30,30,39,126
5586,26,32,31,35,124
5587,34,27,34,33,128
5588,23,31,24,36,114
5589,32,28,30,23,113
5590,31,32,29,37,129
5591,31,35,27,35,128
5592,29,31,25,34,119
5593,38,30,26,31,125
5594,31,26,37,36,130
5595,28,30,31,28,117
5596,31,28,27,36,122
5597,28,27,38,33,126
5598,30,29,24,50,133
5599,29,32,28,24,113
5600,43,31,27,31,132
5601,48,22,29,25,124
5602,29,24,30,25,108
5603,24,42,27,33,126
5604,34,34,34,21,123
5605,26,35,29,35,125
5606,31,34,31,31,127
5607,28,34,32,38,132
5608,32,27,25,33,117
5609,33,28,26,39,126
5610,26,31,32,22,111
5611,31,40,32,28,131
5612,40,26,29,41,136
5613,38,26,23,30,117
5614,22,27,31,29,109
5615,28,33,29,38,128
5616,31,28,35,44,138
5617,27,32,23,28,110
5618,30,36,31,35,132
5619,39,21,36,25,121
5620,26,29,27,38,120
5621,31,27,37,29,124
5622,34,33,35,32,134
5623,32,23,29,35,119
5624,36,23,20,29,108
5625,33,33,39,34,139
5626,30,24,34,25,113
5627,30,26,25,37,118
5628,34,32,34,26,126
5629,27,30,29,31,117
5630,23,31,33,34,121
5631,28,33,30,38,129
5632,34,30,30,28,122
5633,33,29,36,41,139
5634,41,24,34,30,129
5635,34,31,34,34,133
5636,30,29,28,34,121
5637,25,38,33,39,135
5638,40,32,32,40,144
5639,22,31,43,26,122
5640,30,34,32,28,124
5641,35,31,26,26,118
5642,28,36,35,26,125
5643,29,29,24,34,116
5644,32,32,29,21,114
5645,35,33,23,26,117
5646,28,34,27,35,124
5647,30,36,31,22,119
5648,35,31,32,31,129
5649,32,25,31,34,122
5650,27,32,26,31,116
5651,29,25,27,33,114
5652,23,34,33,28,118
5653,31,41,33,27,132
5654,30,26,34,38,128
5655,32,33,40,32,137
5656,33,26,25,22,106
5657,27,35,38,29,129
5658,32,18,33,32,115
5659,19,29,34,32,114
5660,22,27,28,37,114
5661,33,33,31,23,120
5662,25,32,33,35,125
5663,22,27,35,32,116
5664,30,35,33,33,131
5665,32,33,45,30,140
5666,34,31,25,37,127
5667,35,29,29,35,128
5668,29,32,37,30,128
5669,36,35,23,29,123
5670,29,28,17,36,110
5671,41,35,32,29,137
5672,35,27,33,32,127
5673,25,31,39,32,127
5674,35,23,18,28,104
5675,34,30,27,39,130
5676,30,26,30,24,110
5677,42,36,25,29,132
5678,30,32,38,28,128
5679,33,26,30,21,110
5680,28,33,34,37,132
5681,22,26,34,33,115
5682,35,30,28,29,122
5683,26,35,24,25,110
5684,37,31,30,34,132
5685,44,26,24,26,120
5686,34,29,27,34,124
5687,35,34,29,30,128
5688,48,23,38,28,137
5689,34,35,34,38,141
5690,28,30,31,20,109
5691,26,43,29,22,120
5692,24,32,36,23,115
5693,41,33,43,22,139
5694,33,35,36,30,134
5695,37,34,36,23,130
5696,28,31,29,22,110
5697,30,22,34,24,110
5698,38,29,28,30,125
5699,35,28,40,29,132
5700,36,25,26,31,118
5701,37,37,26,37,137
5702,36,34,28,27,125
5703,34,27,33,28,122
5704,29,34,33,31,127
5705,29,32,23,31,115
5706,39,33,29,27,128
5707,24,33,24,33,114
5708,41,28,26,33,128
5709,32,36,36,28,132
5710,41,34,30,30,135
5711,37,35,17,30,119
5712,31,42,30,24,127
5713,22,41,36,36,135
5714,33,32,21,29,115
5715,30,34,38,31,133
5716,20,31,30,26,107
5717,30,32,40,25,127
5718,28,28,34,33,123
5719,29,28,23,28,108
5720,28,34,32,37,131
5721,36,33,37,26,132
5722,32,27,23,28,110
5723,35,37,35,44,151
5724,33,21,40,26,120
5725,21,26,36,30,113
5726,26,26,30,26,108
5727,44,32,31,28,135
5728,23,26,26,31,106
5729,28,46,24,35,133
5730,35,34,29,32,130
5731,36,34,37,27,134
5732,29,36,28,29,122
5733,30,40,31,30,131
5734,40,18,32,34,124
5735,43,29,20,34,126
5736,31,28,27,34,120
5737,29,32,27,28,116
5738,38,33,26,30,127
5739,39,28,23,36,126
5740,36,33,25,33,127
5741,31,32,32,36,131
5742,28,28,30,37,123
5743,17,35,39,33,124
5744,28,33,36,30,127
5745,33,35,28,25,121
5746,31,27,35,32,125
5747,42,36,20,34,132
5748,26,35,27,36,124
5749,33,25,37,44,139
5750,36,32,33,33,134
5751,38,29,38,29,134
5752,34,33,42,28,137
5753,31,28,32,30,121
5754,28,30,34,35,127
5755,32,32,26,34,124
5756,41,25,23,36,125
5757,25,25,28,41,119
5758,26,32,33,38,129
5759,25,35,34,35,129
5760,21,31,39,34,125
5761,28,33,33,34,128
5762,35,33,32,41,141
5763,24,36,32,24,116
5764,22,23,37,35,117
5765,28,33,35,33,129
5766,30,26,33,32,121
5767,30,24,23,28,105
5768,31,28,38,27,124
5769,28,31,41,29,129
5770,33,25,33,35,126
5771,43,28,33,29,133
5772,20,31,26,30,107
5773,26,28,31,36,121
5774,25,37,32,38,132
5775,39,28,31,44,142
5776,28,38,27,24,117
5777,27,27,33,34,121
5778,31,19,35,31,116
5779,36,22,27,34,119
5780,20,26,23,33,102
5781,21,38,31,30,120
5782,30,27,31,31,119
5783,34,42,37,32,145
5784,26,24,24,36,110
5785,27,31,31,31,120
5786,32,27,27,24,110
5787,34,33,34,29,130
5788,31,33,23,39,126
5789,39,35,33,29,136
5790,38,27,29,36,130
5791,31,32,25,26,114
5792,30,38,22,40,130
5793,33,26,25,28,112
5794,34,35,27,27,123
5795,31,24,32,50,137
5796,30,41,31,33,135
5797,23,30,26,31,110
5798,31,31,30,29,121
5799,36,26,29,31,122
5800,20,30,29,33,112
5801,42,31,38,28,139
5802,26,23,28,23,100
5803,34,36,33,24,127
5804,37,27,35,44,143
5805,25,27,35,26,113
5806,27,29,35,25,116
5807,34,30,46,32,142
5808,44,32,33,39,148
5809,27,26,28,31,112
5810,25,27,46,22,120
5811,32,28,27,24,111
5812,31,26,33,41,131
5813,41,38,36,32,147
5814,26,35,24,27,112
5815,32,27,39,36,134
5816,30,36,35,27,128
5817,29,32,46,35,142
5818,30,25,27,33,115
5819,32,36,23,32,123
5820,25,36,30,32,123
5821,29,32,32,28,121
5822,31,28,34,26,119
5823,28,28,25,35,116
5824,31,25,32,29,117
5825,26,43,29,19,117
5826,28,35,31,34,128
5827,23,26,39,33,121
5828,39,27,31,37,134
5829,33,38,24,37,132
5830,33,33,33,34,133
5831,32,34,32,32,130
5832,28,31,21,25,105
5833,34,42,31,34,141
5834,43,37,34,39,153
5835,21,19,37,26,103
5836,43,23,31,28,125
5837,37,26,35,27,125
5838,31,38,36,31,136
5839,29,30,30,34,123
5840,36,31,25,23,115
5841,22,36,33,26,117
5842,27,31,36,28,122
5843,30,25,24,33,112
5844,29,27,28,32,116
5845,15,33,27,25,100
5846,30,33,33,27,123
5847,27,36,28,26,117
5848,30,26,41,30,127
5849,37,38,25,37,137
5850,29,31,31,29,120
5851,34,39,31,40,144
5852,29,32,30,26,117
5853,36,32,28,33,129
5854,32,29,31,39,131
5855,41,36,24,27,128
5856,40,28,30,29,127
5857,32,35,30,32,129
5858,31,29,31,29,120
5859,31,32,28,38,129
5860,28,37,23,33,121
5861,38,35,41,31,145
5862,20,30,32,32,114
5863,35,26,38,23,122
5864,28,30,39,32,129
5865,34,18,33,38,123
5866,39,25,33,30,127
5867,32,26,36,28,122
5868,36,36,25,27,124
5869,36,9,22,28,95
5870,24,19,30,28,101
5871,33,31,44,41,149
5872,27,30,33,36,126
5873,30,31,30,33,124
5874,38,37,38,23,136
5875,33,19,32,29,113
5876,30,30,26,32,118
5877,29,35,31,28,123
5878,33,27,34,35,129
5879,32,29,20,27,108
5880,40,30,27,33,130
5881,27,33,34,21,115
5882,27,34,27,43,131
5883,34,30,37,25,126
5884,32,35,33,34,134
5885,33,33,31,33,130
5886,33,37,25,24,119
5887,38,19,24,30,111
5888,27,31,38,30,126
5889,39,35,35,37,146
5890,29,40,38,38,145
5891,27,29,30,43,129
5892,36,32,34,27,129
5893,28,25,34,30,117
5894,35,29,32,27,123
5895,29,33,27,20,109
5896,34,42,30,35,141
5897,35,32,27,32,126
5898,41,30,24,27,122
5899,28,28,39,21,116
5900,37,30,31,23,121
5901,36,32,31,25,124
5902,32,27,36,33,128
5903,34,26,39,27,126
5904,22,28,48,32,130
5905,33,33,32,29,127
5906,35,26,31,36,128
5907,39,35,40,32,146
5908,30,37,37,27,131
5909,37,43,21,37,138
5910,35,32,30,35,132
5911,41,24,32,33,130
5912,16,26,25,30,97
5913,34,44,35,24,137
5914,32,29,30,32,123
5915,37,28,40,34,139
5916,31,26,40,25,122
5917,37,29,35,29,130
5918,26,36,32,31,125
5919,36,30,27,20,113
5920,32,35,41,29,137
5921,22,38,32,34,126
5922,32,30,29,41,132
5923,17,34,41,27,119
5924,29,35,39,37,140
5925,29,34,28,25,116
5926,35,25,39,39,138
5927,26,49,28,30,133
5928,34,30,37,35,136
5929,35,23,47,31,136
5930,31,23,22,28,104
5931,23,40,45,25,133
5932,21,35,36,34,126
5933,31,29,35,27,122
5934,28,31,37,18,114
5935,38,35,23,25,121
5936,24,29,42,34,129
5937,19,41,28,33,121
5938,29,24,35,26,114
5939,27,30,35,35,127
5940,31,29,42,34,136
5941,39,17,33,39,128
5942,26,33,30,28,117
5943,33,36,25,26,120
5944,39,22,41,29,131
5945,43,32,28,33,136
5946,32,34,30,28,124
5947,30,32,20,30,112
5948,28,27,32,26,113
5949,26,30,32,35,123
5950,33,33,36,37,139
5951,25,43,36,26,130
5952,33,25,42,26,126
5953,36,30,25,31,122
5954,38,32,37,34,141
5955,31,31,30,27,119
5956,32,28,35,27,122
5957,28,26,35,28,117
5958,36,29,27,29,121
5959,34,39,26,34,133
5960,26,33,33,31,123
5961,33,28,33,39,133
5962,35,40,31,30,136
5963,30,32,27,28,117
5964,32,32,27,35,126
5965,35,31,29,33,128
5966,33,29,25,37,124
5967,45,32,43,36,156
5968,40,28,29,31,128
5969,27,27,27,35,116
5970,28,31,33,30,122
5971,30,26,30,38,124
5972,32,39,27,26,124
5973,33,38,21,33,125
5974,29,27,25,36,117
5975,28,32,34,29,123
5976,27,25,36,32,120
5977,39,32,34,27,132
5978,35,36,37,29,137
5979,36,30,36,41,143
5980,31,31,23,34,119
5981,36,27,27,42,132
5982,31,24,45,34,134
5983,38,24,27,32,121
5984,26,31,38,25,120
5985,24,24,14,36,98
5986,37,22,31,28,118
5987,23,32,39,29,123
5988,29,30,25,30,114
5989,22,22,32,36,112
5990,21,29,32,28,110
5991,25,25,29,30,109
5992,39,36,36,23,134
5993,30,33,39,35,137
5994,27,29,29,28,113
5995,25,26,34,30,115
5996,44,27,35,30,136
5997,25,31,25,32,113
5998,31,30,33,36,130
5999,31,29,37,27,124
6000,24,21,32,46,123
6001,30,27,26,27,110
6002,30,31,27,35,123
6003,38,27,32,36,133
6004,28,29,36,26,119
6005,28,35,37,32,132
6006,28,27,28,34,117
6007,46,42,28,29,145
6008,37,47,31,28,143
6009,31,29,29,30,119
6010,21,36,32,40,129
6011,37,37,44,40,158
6012,37,39,32,37,145
6013,32,30,33,30,125
6014,31,32,26,29,118
6015,43,33,31,23,130
6016,24,37,39,19,119
6017,33,21,30,26,110
6018,29,18,24,27,98
6019,29,38,37,26,130
6020,26,40,38,33,137
6021,37,28,35,41,141
6022,42,29,34,29,134
6023,23,38,42,34,137
6024,21,36,43,39,139
6025,32,25,39,37,133
6026,36,28,35,30,129
6027,25,36,22,29,112
6028,28,22,43,37,130
6029,38,32,30,24,124
6030,26,34,44,35,139
6031,33,32,26,37,128
6032,40,45,32,23,140
6033,28,26,30,32,116
6034,31,26,27,24,108
6035,31,28,40,25,124
6036,32,41,23,34,130
6037,29,23,28,34,114
6038,30,26,27,35,118
6039,29,33,33,27,122
6040,20,36,29,25,110
6041,36,31,35,37,139
6042,31,24,30,27,112
6043,28,33,36,32,129
6044,25,40,32,39,136
6045,30,31,20,51,132
6046,38,40,22,29,129
6047,31,30,26,25,112
6048,27,29,22,35,113
6049,26,34,29,39,128
6050,29,31,36,31,127
6051,21,31,31,36,119
6052,31,31,23,27,112
6053,37,30,21,38,126
6054,24,47,30,25,126
6055,21,24,37,23,105
6056,31,30,28,29,118
6057,37,28,26,37,128
6058,36,33,29,26,124
6059,30,27,28,28,113
6060,34,35,23,29,121
6061,38,37,23,30,128
6062,31,36,40,33,140
6063,24,33,31,35,123
6064,32,29,35,26,122
6065,29,32,33,28,122
6066,24,29,31,25,109
6067,30,32,30,25,117
6068,24,26,25,36,111
6069,28,33,34,26,121
6070,30,27,30,44,131
6071,35,27,30,30,122
6072,42,36,35,33,146
6073,25,28,32,27,112
6074,29,38,38,32,137
6075,28,38,31,36,133
6076,26,27,36,33,122
6077,31,27,35,29,122
6078,31,28,32,34,125
6079,30,30,27,31,118
6080,36,25,35,36,132
6081,23,24,43,28,118
6082,28,28,36,26,118
6083,33,28,37,34,132
6084,28,29,31,30,118
6085,35,29,36,34,134
6086,34,28,35,28,125
6087,23,33,27,52,135
6088,38,33,34,27,132
6089,39,24,32,29,124
6090,28,33,27,26,114
6091,33,28,36,30,127
6092,27,40,25,33,125
6093,43,39,32,35,149
6094,28,34,24,42,128
6095,31,19,24,39,113
6096,33,30,32,40,135
6097,24,29,35,29,117
6098,35,36,31,32,134
6099,32,29,30,35,126
6100,29,38,34,35,136
6101,27,29,33,30,119
6102,31,43,28,29,131
6103,29,35,31,27,122
6104,39,26,25,35,125
6105,28,25,25,33,111
6106,27,14,34,39,114
6107,34,33,31,29,127
6108,25,27,27,30,109
6109,51,24,38,36,149
6110,26,30,38,34,128
6111,27,33,27,27,114
6112,35,27,32,35,129
6113,25,29,35,27,116
6114,38,34,29,35,136
6115,36,29,27,37,129
6116,31,37,23,31,122
6117,15,31,28,22,96
6118,36,38,30,30,134
6119,39,19,33,25,116
6120,32,23,32,23,110
6121,29,24,36,36,125
6122,36,30,32,36,134
6123,30,21,25,27,103
6124,32,30,27,33,122
6125,22,35,32,34,123
6126,31,36,30,39,136
6127,31,30,26,31,118
6128,28,30,35,29,122
6129,32,36,38,29,135
6130,28,29,33,29,119
6131,30,31,28,30,119
6132,27,32,25,28,112
6133,32,27,26,28,113
6134,24,33,26,23,106
6135,25,41,23,34,123
6136,35,37,28,19,119
6137,21,29,20,34,104
6138,26,40,38,39,143
6139,32,32,36,25,125
6140,33,39,35,28,135
6141,29,43,37,27,136
6142,29,23,36,34,122
6143,22,39,39,30,130
6144,28,36,32,30,126
6145,36,32,27,28,123
6146,37,31,42,32,142
6147,39,23,32,26,120
6148,37,26,29,37,129
6149,29,37,26,28,120
6150,26,31,36,33,126
6151,33,32,30,37,132
6152,40,35,35,31,141
6153,29,33,27,32,121
6154,26,37,30,38,131
6155,24,31,41,31,127
6156,25,28,33,35,121
6157,26,31,37,29,123
6158,25,31,28,29,113
6159,34,40,36,32,142
6160,31,36,34,34,135
6161,24,22,37,37,120
6162,26,42,29,30,127
6163,34,25,38,32,129
6164,36,31,25,36,128
6165,32,29,42,27,130
6166,35,19,28,38,120
6167,32,30,39,32,133
6168,43,28,37,31,139
6169,32,37,30,26,125
6170,22,31,35,36,124
6171,31,34,36,22,123
6172,29,34,29,37,129
6173,28,26,33,38,125
6174,37,33,35,32,137
6175,31,27,35,44,137
6176,25,35,37,36,133
6177,24,29,19,39,111
6178,24,38,25,32,119
6179,36,33,30,24,123
6180,29,38,27,26,120
6181,29,31,29,29,118
6182,39,34,29,28,130
6183,29,29,37,29,124
6184,27,40,34,27,128
6185,19,32,36,27,114
6186,33,36,26,36,131
6187,40,36,28,34,138
6188,31,23,34,36,124
6189,39,38,36,41,154
6190,27,28,25,33,113
6191,32,37,37,24,130
6192,28,37,38,42,145
6193,29,27,32,36,124
6194,27,34,34,24,119
6195,24,46,23,30,123
6196,30,27,36,35,128
6197,31,21,35,25,112
6198,30,35,33,29,127
6199,36,32,25,25,118
6200,31,38,24,34,127
6201,29,40,41,32,142
6202,47,26,23,26,122
6203,36,30,33,29,128
6204,27,31,29,35,122
6205,32,41,33,40,146
6206,24,33,29,33,119
6207,31,34,29,29,123
6208,41,32,29,30,132
6209,28,35,38,25,126
6210,34,34,34,25,127
6211,32,28,26,30,116
6212,29,25,29,33,116
6213,27,29,34,35,125
6214,26,37,28,32,123
6215,29,29,27,29,114
6216,27,28,31,36,122
6217,20,27,28,36,111
6218,35,22,26,32,115
6219,40,25,31,36,132
6220,28,27,25,38,118
6221,33,34,30,23,120
6222,36,26,33,28,123
6223,25,29,27,24,105
6224,25,27,29,31,112
6225,28,29,29,45,131
6226,34,28,24,30,116
6227,23,21,24,30,98
6228,27,32,29,37,125
6229,29,28,29,31,117
6230,37,33,39,29,138
6231,31,32,35,35,133
6232,33,29,23,38,123
6233,33,29,28,34,124
6234,28,37,36,26,127
6235,27,36,24,33,120
6236,30,35,45,29,139
6237,27,23,32,36,118
6238,29,26,22,30,107
6239,26,30,37,30,123
6240,29,35,29,37,130
6241,36,30,33,23,122
6242,40,20,33,29,122
6243,31,31,39,35,136
6244,24,36,33,29,122
6245,32,35,29,30,126
6246,31,36,26,29,122
6247,24,32,35,36,127
6248,38,25,31,33,127
6249,34,28,27,32,121
6250,34,37,29,37,137
6251,28,34,33,31,126
6252,28,34,34,34,130
6253,23,25,28,35,111
6254,21,28,29,22,100
6255,28,36,34,29,127
6256,29,39,32,31,131
6257,33,35,34,41,143
6258,34,36,28,35,133
6259,37,27,30,34,128
6260,33,26,28,33,120
6261,38,32,35,33,138
6262,27,29,31,35,122
6263,33,32,29,20,114
6264,30,22,31,25,108
6265,37,32,24,24,117
6266,28,31,33,26,118
6267,32,27,32,34,125
6268,32,25,28,23,108
6269,28,30,31,27,116
6270,37,31,29,35,132
6271,32,25,39,39,135
6272,34,39,36,27,136
6273,33,40,30,23,126
6274,39,29,31,35,134
6275,33,34,37,25,129
6276,33,43,34,32,142
6277,19,33,30,47,129
6278,31,39,28,42,140
6279,31,24,23,30,108
6280,38,33,34,30,135
6281,25,25,30,26,106
6282,29,33,30,39,131
6283,30,28,25,23,106
6284,26,25,33,37,121
6285,39,26,26,27,118
6286,28,35,32,32,127
6287,37,37,29,27,130
6288,34,25,39,39,137
6289,31,22,42,26,121
6290,37,26,21,32,116
6291,22,25,33,27,107
6292,34,31,25,34,124
6293,35,24,32,37,128
6294,40,33,44,19,136
6295,35,21,29,25,110
6296,35,36,28,38,137
6297,26,35,28,27,116
6298,33,34,40,26,133
6299,40,32,30,21,123
6300,28,30,31,30,119
6301,27,29,39,29,124
6302,41,23,38,28,130
6303,32,30,32,36,130
6304,24,30,33,27,114
6305,32,27,36,27,122
6306,33,26,24,37,120
6307,32,30,37,34,133
6308,37,22,29,25,113
6309,28,33,26,27,114
6310,32,32,28,42,134
6311,28,29,42,37,136
6312,40,27,32,25,124
6313,31,31,29,21,112
6314,29,25,38,33,125
6315,37,28,37,27,129
6316,44,33,27,30,134
6317,34,34,40,29,137
6318,28,28,32,28,116
6319,25,33,28,32,118
6320,28,39,33,35,135
6321,34,30,27,34,125
6322,29,39,18,24,110
6323,37,26,23,31,117
6324,22,28,36,32,118
6325,34,24,29,26,113
6326,25,31,40,28,124
6327,29,30,25,30,114
6328,30,44,20,32,126
6329,41,27,26,40,134
6330,33,29,31,32,125
6331,31,30,22,33,116
6332,40,36,31,22,129
6333,34,40,30,30,134
6334,25,27,19,35,106
6335,25,27,38,25,115
6336,27,28,34,30,119
6337,30,28,33,25,116
6338,34,26,34,25,119
6339,36,29,31,31,127
6340,35,42,23,29,129
6341,27,31,34,30,122
6342,31,33,26,31,121
6343,21,36,23,24,104
6344,35,36,33,35,139
6345,34,32,27,35,128
6346,31,34,32,35,132
6347,29,31,28,30,118
6348,33,28,34,33,128
6349,40,25,28,39,132
6350,37,29,29,30,125
6351,37,29,39,29,134
6352,26,28,37,28,119
6353,25,25,35,38,123
6354,41,27,34,26,128
6355,37,24,30,32,123
6356,27,30,33,29,119
6357,28,29,24,20,101
6358,31,35,35,37,138
6359,35,28,30,23,116
6360,32,33,34,43,142
6361,42,30,31,27,130
6362,31,28,29,33,121
6363,33,36,31,25,125
6364,33,26,29,25,113
6365,29,31,36,36,132
6366,30,34,42,36,142
6367,35,44,32,39,150
6368,15,36,31,29,111
6369,29,31,50,31,141
6370,33,33,28,30,124
6371,34,22,25,28,109
6372,23,21,34,31,109
6373,35,26,29,37,127
6374,27,31,31,28,117
6375,26,25,24,43,118
6376,30,43,33,39,145
6377,34,40,28,41,143
6378,25,31,29,29,114
6379,31,22,36,30,119
6380,45,27,19,46,137
6381,32,36,36,30,134
6382,37,29,29,27,122
6383,27,27,30,34,118
6384,21,46,29,30,126
6385,39,33,28,27,127
6386,38,30,37,34,139
6387,28,33,24,28,113
6388,23,24,26,24,97
6389,38,36,25,15,114
6390,38,33,23,35,129
6391,38,31,22,36,127
6392,20,34,26,30,110
6393,40,27,25,29,121
6394,33,30,28,29,120
6395,30,31,25,28,114
6396,27,29,32,30,118
6397,28,30,28,21,107
6398,39,33,32,28,132
6399,31,39,30,23,123
6400,33,31,28,28,120
6401,25,28,27,30,110
6402,27,27,32,28,114
6403,44,31,29,32,136
6404,25,25,36,32,118
6405,40,22,38,28,128
6406,27,28,41,33,129
6407,23,30,25,23,101
6408,27,27,19,36,109
6409,26,30,42,28,126
6410,27,34,33,35,129
6411,33,40,22,20,115
6412,34,26,28,28,116
6413,21,47,38,33,139
6414,36,34,29,31,130
6415,34,42,25,36,137
6416,27,40,29,30,126
6417,31,31,21,30,113
6418,23,26,22,34,105
6419,39,30,30,33,132
6420,29,40,32,30,131
6421,34,32,28,23,117
6422,32,35,24,31,122
6423,36,24,38,34,132
6424,15,41,26,35,117
6425,24,27,36,28,115
6426,27,38,28,31,124
6427,39,31,22,37,129
6428,23,31,29,39,122
6429,30,25,29,33,117
6430,37,34,32,26,129
6431,29,31,33,35,128
6432,34,29,41,22,126
6433,28,26,31,30,115
6434,30,38,27,30,125
6435,30,30,31,37,128
6436,28,33,32,24,117
6437,34,26,28,24,112
6438,35,39,31,35,140
6439,36,29,29,32,126
6440,32,28,36,36,132
6441,32,34,31,30,127
6442,32,33,29,31,125
6443,26,33,30,37,126
6444,27,35,30,40,132
6445,25,31,30,36,122
6446,26,38,40,34,138
6447,30,31,33,35,129
6448,30,31,43,33,137
6449,24,36,20,35,115
6450,22,39,34,32,127
6451,33,38,36,33,140
6452,31,33,28,22,114
6453,30,33,34,25,122
6454,33,28,24,33,118
6455,22,26,28,30,106
6456,31,40,32,27,130
6457,31,27,33,34,125
6458,36,40,33,35,144
6459,29,33,28,26,116
6460,35,29,37,32,133
6461,23,20,22,32,97
6462,25,31,29,28,113
6463,28,29,45,25,127
6464,43,37,21,26,127
6465,30,27,21,33,111
6466,40,35,25,32,132
6467,28,30,39,33,130
6468,23,31,34,35,123
6469,36,33,21,32,122
6470,30,26,28,29,113
6471,34,38,21,29,122
6472,32,22,22,36,112
6473,36,38,31,33,138
6474,36,31,20,43,130
6475,28,31,33,36,128
6476,38,30,23,29,120
6477,33,34,32,33,132
6478,33,25,24,34,116
6479,29,38,30,30,127
6480,24,34,33,32,123
6481,38,25,31,20,114
6482,31,35,33,25,124
6483,31,42,29,26,128
6484,33,35,30,37,135
6485,30,34,25,33,122
6486,26,36,43,39,144
6487,37,34,39,36,146
6488,34,26,27,30,117
6489,19,30,29,26,104
6490,41,42,33,27,143
6491,24,35,31,38,128
6492,26,23,36,25,110
6493,37,31,21,28,117
6494,36,32,21,30,119
6495,32,41,34,30,137
6496,32,29,36,34,131
6497,37,34,33,39,143
6498,37,29,47,36,149
6499,35,34,22,28,119
6500,24,28,31,38,121
6501,30,27,29,21,107
6502,30,25,31,30,116
6503,27,33,35,24,119
6504,25,32,26,22,105
6505,23,29,32,35,119
6506,36,25,29,38,128
6507,30,44,42,26,142
6508,22,33,36,35,126
6509,27,33,39,37,136
6510,30,36,38,29,133
6511,22,34,30,19,105
6512,32,31,36,35,134
6513,25,23,41,32,121
6514,24,26,35,35,120
6515,32,39,21,36,128
6516,31,37,37,20,125
6517,34,27,33,27,121
6518,25,44,35,30,134
6519,33,24,24,30,111
6520,27,23,30,22,102
6521,28,33,26,30,117
6522,37,38,40,22,137
6523,39,36,32,25,132
6524,25,39,15,40,119
6525,23,40,45,31,139
6526,32,31,34,35,132
6527,40,32,30,32,134
6528,40,28,34,37,139
6529,32,25,28,26,111
6530,21,33,29,33,116
6531,41,32,27,40,140
6532,29,30,28,30,117
6533,29,36,24,34,123
6534,38,25,33,36,132
6535,35,34,37,23,129
6536,37,34,37,24,132
6537,25,35,28,39,127
6538,27,21,31,26,105
6539,33,31,33,31,128
6540,39,37,34,22,132
6541,31,36,27,35,129
6542,30,42,28,31,131
6543,41,39,31,38,149
6544,33,28,38,24,123
6545,42,24,34,41,141
6546,33,32,36,40,141
6547,31,28,34,25,118
6548,30,38,32,30,130
6549,23,30,36,24,113
6550,28,21,39,22,110
6551,37,28,24,41,130
6552,35,34,33,31,133
6553,41,29,27,30,127
6554,20,41,30,33,124
6555,29,31,37,28,125
6556,26,40,33,36,135
6557,37,25,33,35,130
6558,32,20,31,31,114
6559,33,31,34,21,119
6560,28,35,31,27,121
6561,29,34,44,25,132
6562,30,38,34,41,143
6563,36,27,39,33,135
6564,36,39,40,22,137
6565,25,42,27,30,124
6566,32,26,29,35,122
6567,37,28,28,33,126
6568,34,43,37,33,147
6569,28,21,29,37,115
6570,34,33,19,39,125
6571,35,36,31,24,126
6572,38,29,28,34,129
6573,33,26,35,29,123
6574,35,39,25,32,131
6575,23,32,28,28,111
6576,25,29,44,26,124
6577,28,29,24,29,110
6578,28,29,35,30,122
6579,39,36,34,26,135
6580,27,36,28,33,124
6581,39,32,37,27,135
6582,36,33,40,21,130
6583,28,40,24,24,116
6584,37,33,30,26,126
6585,34,29,37,25,125
6586,36,22,35,27,120
6587,41,34,32,31,138
6588,36,35,30,29,130
6589,38,21,39,36,134
6590,29,28,25,43,125
6591,35,26,30,31,122
6592,36,32,32,39,139
6593,35,33,38,35,141
6594,28,31,34,23,116
6595,30,29,24,29,112
6596,41,28,31,33,133
6597,26,32,25,31,114
6598,37,39,31,30,137
6599,29,33,25,34,121
6600,42,27,38,51,158
6601,35,25,17,20,97
6602,32,37,26,27,122
6603,20,29,36,35,120
6604,21,39,46,26,132
6605,25,29,32,26,112
6606,34,30,31,34,129
6607,39,27,32,25,123
6608,29,32,26,46,133
6609,37,35,27,38,137
6610,39,22,30,43,134
6611,31,30,29,35,125
6612,28,38,28,38,132
6613,19,29,40,34,122
6614,25,31,27,37,120
6615,33,27,31,36,127
6616,23,28,39,36,126
6617,30,35,25,23,113
6618,29,31,24,25,109
6619,36,19,45,25,125
6620,42,36,35,33,146
6621,28,32,37,29,126
6622,35,45,20,26,126
6623,29,32,27,29,117
6624,27,34,25,29,115
6625,20,30,37,28,115
6626,29,31,32,31,123
6627,34,27,31,32,124
6628,34,38,38,27,137
6629,37,37,33,30,137
6630,44,37,22,34,137
6631,26,23,34,29,112
6632,32,37,29,32,130
6633,26,39,34,34,133
6634,38,38,33,31,140
6635,24,27,24,25,100
6636,20,38,36,30,124
6637,32,35,33,34,134
6638,25,34,28,30,117
6639,22,33,31,35,121
6640,47,38,40,30,155
6641,37,29,30,43,139
6642,23,27,22,30,102
6643,34,30,40,29,133
6644,32,25,29,31,117
6645,27,46,24,30,127
6646,25,30,21,39,115
6647,37,23,37,21,118
6648,31,30,38,31,130
6649,30,35,33,26,124
6650,27,27,22,34,110
6651,26,27,38,38,129
6652,30,35,34,30,129
6653,30,30,30,24,114
6654,26,29,39,29,123
6655,22,27,29,43,121
6656,23,37,38,31,129
6657,26,33,39,46,144
6658,33,30,48,35,146
6659,31,35,38,30,134
6660,31,30,23,29,113
6661,32,28,32,35,127
6662,36,36,38,37,147
6663,29,33,30,23,115
6664,18,30,32,32,112
6665,36,24,35,37,132
6666,25,34,22,26,107
6667,33,36,19,30,118
6668,29,39,26,35,129
6669,38,23,22,26,109
6670,35,18,37,36,126
6671,37,26,26,33,122
6672,33,20,26,30,109
6673,26,39,29,35,129
6674,39,33,35,25,132
6675,30,28,36,40,134
6676,28,32,33,44,137
6677,26,33,23,24,106
6678,31,42,22,35,130
6679,33,28,29,35,125
6680,28,29,40,28,125
6681,31,43,27,38,139
6682,42,30,42,33,147
6683,35,31,31,35,132
6684,31,33,40,26,130
6685,34,36,32,28,130
6686,31,24,30,34,119
6687,26,29,37,35,127
6688,38,39,26,27,130
6689,33,30,15,31,109
6690,21,41,24,34,120
6691,35,28,38,37,138
6692,38,20,24,35,117
6693,34,32,32,31,129
6694,21,25,21,25,92
6695,22,19,40,33,114
6696,27,22,24,39,112
6697,37,45,28,33,143
6698,27,32,37,21,117
6699,39,38,41,40,158
6700,25,35,27,31,118
6701,31,32,38,28,129
6702,39,33,26,19,117
6703,35,34,23,30,122
6704,23,36,32,34,125
6705,40,36,35,33,144
6706,36,26,27,40,129
6707,22,29,31,27,109
6708,31,23,42,25,121
6709,36,26,29,27,118
6710,20,29,27,38,114
6711,27,38,30,33,128
6712,39,25,31,28,123
6713,34,39,23,36,132
6714,23,32,33,41,129
6715,33,33,20,32,118
6716,29,27,34,34,124
6717,21,36,23,38,118
6718,42,31,36,24,133
6719,44,23,38,31,136
6720,31,35,40,28,134
6721,38,31,39,20,128
6722,35,24,30,34,123
6723,32,30,31,30,123
6724,27,24,25,35,111
6725,38,35,28,38,139
6726,37,35,26,27,125
6727,25,33,31,30,119
6728,35,36,40,32,143
6729,34,40,40,32,146
6730,30,32,37,26,125
6731,38,40,25,35,138
6732,32,32,27,27,118
6733,32,35,34,25,126
6734,27,27,28,31,113
6735,30,31,41,30,132
6736,25,29,38,32,124
6737,24,39,46,25,134
6738,35,30,20,22,107
6739,28,34,30,35,127
6740,39,27,32,29,127
6741,21,26,31,29,107
6742,25,37,28,40,130
6743,25,29,29,44,127
6744,35,30,20,39,124
6745,32,36,33,24,125
6746,31,32,29,37,129
6747,41,30,29,26,126
6748,24,27,30,29,110
6749,29,35,35,34,133
6750,25,29,28,30,112
6751,25,32,27,43,127
6752,27,31,18,28,104
6753,34,31,22,28,115
6754,27,35,31,25,118
6755,33,32,29,32,126
6756,34,26,22,35,117
6757,39,36,27,29,131
6758,35,41,32,26,134
6759,35,27,32,31,125
6760,35,34,29,29,127
6761,33,29,33,36,131
6762,30,21,32,24,107
6763,39,30,35,23,127
6764,27,23,36,25,111
6765,28,29,23,41,121
6766,25,32,29,35,121
6767,27,27,29,20,103
6768,26,40,41,19,126
6769,31,40,34,30,135
6770,19,28,35,36,118
6771,27,35,27,29,118
6772,25,31,36,32,124
6773,18,33,33,31,115
6774,22,37,32,29,120
6775,36,27,21,29,113
6776,29,41,33,25,128
6777,37,22,38,22,119
6778,34,37,28,33,132
6779,37,34,44,24,139
6780,27,26,40,32,125
6781,29,32,37,31,129
6782,34,29,36,33,132
6783,35,32,37,36,140
6784,30,40,33,28,131
6785,29,43,35,42,149
6786,22,28,26,29,105
6787,23,36,31,30,120
6788,28,31,30,36,125
6789,42,22,34,29,127
6790,44,32,27,26,129
6791,27,40,40,32,139
6792,33,27,39,35,134
6793,30,29,21,40,120
6794,35,29,41,35,140
6795,29,31,27,23,110
6796,30,35,40,34,139
6797,33,38,32,17,120
6798,35,40,30,38,143
6799,31,34,28,23,116
6800,30,40,39,27,136
6801,42,31,30,31,134
6802,38,31,26,38,133
6803,41,35,31,38,145
6804,25,33,40,39,137
6805,21,27,30,27,105
6806,24,34,38,28,124
6807,27,35,41,37,140
6808,29,32,34,31,126
6809,44,32,32,30,138
6810,42,34,20,32,128
6811,32,30,30,35,127
6812,29,36,31,36,132
6813,29,36,36,33,134
6814,28,47,31,43,149
6815,32,29,29,30,120
6816,33,30,30,28,121
6817,26,39,27,32,124
6818,24,18,37,41,120
6819,29,23,43,31,126
6820,26,37,25,29,117
6821,41,24,31,34,130
6822,33,33,31,29,126
6823,38,31,29,31,129
6824,40,28,43,23,134
6825,31,39,29,37,136
6826,33,36,38,34,141
6827,30,36,21,25,112
6828,29,42,26,39,136
6829,28,26,30,36,120
6830,28,34,33,28,123
6831,29,30,29,36,124
6832,31,28,31,29,119
6833,33,23,26,30,112
6834,30,33,28,26,117
6835,25,34,27,31,117
6836,31,34,32,33,130
6837,18,35,32,38,123
6838,31,34,21,27,113
6839,33,27,27,23,110
6840,21,35,27,45,128
6841,23,35,40,32,130
6842,26,28,37,33,124
6843,29,31,30,16,106
6844,28,39,29,42,138
6845,29,28,38,30,125
6846,33,33,35,45,146
6847,29,34,31,39,133
6848,33,28,27,33,121
6849,34,38,22,29,123
6850,33,33,26,32,124
6851,30,29,24,33,116
6852,32,28,32,25,117
6853,36,30,36,27,129
6854,40,32,31,33,136
6855,35,32,21,36,124
6856,31,31,31,29,122
6857,37,29,29,28,123
6858,39,37,39,25,140
6859,36,27,38,26,127
6860,25,30,24,30,109
6861,29,41,37,31,138
6862,24,23,33,29,109
6863,37,35,33,34,139
6864,25,33,32,32,122
6865,34,36,31,32,133
6866,31,32,28,29,120
6867,31,21,28,34,114
6868,46,32,34,27,139
6869,32,36,41,33,142
6870,28,32,27,29,116
6871,31,26,34,32,123
6872,29,23,29,31,112
6873,34,34,26,37,131
6874,28,39,30,35,132
6875,37,35,32,27,131
6876,21,32,34,33,120
6877,35,32,35,29,131
6878,36,34,34,21,125
6879,25,32,36,21,114
6880,32,30,26,26,114
6881,33,45,29,23,130
6882,32,29,25,30,116
6883,34,23,27,32,116
6884,44,28,30,36,138
6885,29,25,34,34,122
6886,32,19,31,32,114
6887,31,24,21,32,108
6888,24,35,30,35,124
6889,32,31,32,25,120
6890,25,32,28,27,112
6891,36,27,20,23,106
6892,42,29,34,53,158
6893,28,35,42,40,145
6894,33,30,26,28,117
6895,28,25,32,25,110
6896,28,35,35,28,126
6897,32,25,33,33,123
6898,34,34,43,42,153
6899,29,42,25,34,130
6900,27,38,41,32,138
6901,29,31,35,34,129
6902,29,34,30,39,132
6903,24,30,30,28,112
6904,31,23,40,31,125
6905,42,18,33,39,132
6906,32,32,28,45,137
6907,24,35,32,40,131
6908,31,26,27,28,112
6909,34,24,23,24,105
6910,31,24,32,40,127
6911,35,33,33,36,137
6912,29,32,25,35,121
6913,28,34,37,26,125
6914,26,38,31,25,120
6915,21,31,33,28,113
6916,29,36,36,28,129
6917,28,35,25,39,127
6918,32,35,33,38,138
6919,36,42,31,27,136
6920,25,34,26,30,115
6921,36,37,36,29,138
6922,28,26,29,34,117
6923,33,34,28,31,126
6924,33,34,45,23,135
6925,38,25,33,46,142
6926,37,20,19,26,102
6927,33,29,35,34,131
6928,32,33,31,29,125
6929,34,31,42,31,138
6930,36,43,26,29,134
6931,25,32,36,33,126
6932,42,30,36,35,143
6933,36,37,35,20,128
6934,36,31,34,25,126
6935,34,26,35,29,124
6936,43,27,21,42,133
6937,33,35,31,31,130
6938,36,25,27,35,123
6939,38,33,33,31,135
6940,38,21,25,31,115
6941,28,39,36,20,123
6942,37,34,41,33,145
6943,30,28,32,32,122
6944,27,30,34,32,123
6945,29,25,24,25,103
6946,28,30,27,28,113
6947,31,33,26,28,118
6948,25,33,26,31,115
6949,33,39,29,28,129
6950,30,27,27,30,114
6951,37,39,29,30,135
6952,21,25,29,39,114
6953,30,33,30,36,129
6954,28,24,25,30,107
6955,39,32,36,40,147
6956,36,31,25,30,122
6957,35,26,27,31,119
6958,31,32,44,23,130
6959,29,27,23,37,116
6960,31,33,34,32,130
6961,33,28,36,31,128
6962,24,36,28,31,119
6963,32,35,33,38,138
6964,38,24,41,40,143
6965,29,29,28,22,108
6966,38,31,38,35,142
6967,20,26,32,34,112
6968,35,32,34,32,133
6969,42,41,36,31,150
6970,27,29,45,31,132
6971,26,38,28,26,118
6972,32,34,39,39,144
6973,30,33,22,38,123
6974,33,35,25,23,116
6975,35,28,30,24,117
6976,26,35,32,23,116
6977,39,33,35,31,138
6978,34,33,25,25,117
6979,31,32,36,41,140
6980,32,29,33,30,124
6981,32,22,33,23,110
6982,46,30,35,33,144
6983,29,34,33,27,123
6984,38,22,26,34,120
6985,37,30,32,24,123
6986,24,29,33,42,128
6987,36,33,31,26,126
6988,28,29,37,24,118
6989,32,27,31,32,122
6990,24,29,29,27,109
6991,30,46,26,25,127
6992,34,28,33,24,119
6993,28,29,23,32,112
6994,34,43,40,28,145
6995,27,31,29,30,117
6996,23,31,33,31,118
6997,28,28,36,30,122
6998,31,24,26,44,125
6999,32,35,29,27,123
7000,43,26,18,34,121
7001,28,32,37,28,125
7002,28,26,27,29,110
7003,25,36,39,23,123
7004,29,33,37,32,131
7005,33,41,34,29,137
7006,32,31,26,29,118
7007,31,35,20,32,118
7008,28,29,29,39,125
7009,43,23,29,34,129
7010,30,29,27,35,121
7011,26,34,23,34,117
7012,28,31,23,48,130
7013,36,37,32,27,132
7014,32,39,35,26,132
7015,33,38,30,36,137
7016,30,36,32,39,137
7017,23,36,27,32,118
7018,37,36,27,33,133
7019,37,32,28,23,120
7020,32,36,32,36,136
7021,35,35,38,37,145
7022,25,39,42,33,139
7023,29,23,30,22,104
7024,25,33,39,25,122
7025,24,27,33,24,108
7026,30,27,31,22,110
7027,29,35,25,40,129
7028,26,36,21,34,117
7029,27,36,23,33,119
7030,34,31,35,38,138
7031,24,41,36,31,132
7032,22,38,27,28,115
7033,28,36,33,29,126
7034,28,43,28,34,133
7035,39,36,24,31,130
7036,31,42,26,32,131
7037,28,27,19,35,109
7038,36,25,29,32,122
7039,29,35,35,28,127
7040,33,37,32,38,140
7041,32,36,30,30,128
7042,34,23,32,32,121
7043,32,35,39,28,134
7044,26,29,25,37,117
7045,32,31,36,25,124
7046,19,39,29,29,116
7047,32,35,28,30,125
7048,41,29,29,31,130
7049,31,22,28,34,115
7050,33,35,23,28,119
7051,20,28,34,26,108
7052,22,29,33,32,116
7053,28,37,32,26,123
7054,35,25,34,31,125
7055,28,43,47,25,143
7056,30,25,40,22,117
7057,33,27,38,25,123
7058,34,36,32,34,136
7059,35,32,21,25,113
7060,33,32,45,25,135
7061,36,24,34,29,123
7062,37,36,29,32,134
7063,29,23,30,42,124
7064,27,27,29,35,118
7065,31,30,19,42,122
7066,23,37,28,26,114
7067,28,32,34,26,120
7068,26,28,45,20,119
7069,31,41,33,34,139
7070,33,30,25,31,119
7071,40,31,22,34,127
7072,26,29,27,29,111
7073,31,29,30,31,121
7074,29,28,24,29,110
7075,38,25,32,29,124
7076,34,29,30,34,127
7077,28,38,28,24,118
7078,28,31,34,30,123
7079,29,23,38,37,127
7080,34,36,39,28,137
7081,35,32,31,37,135
7082,31,23,32,33,119
7083,36,29,27,28,120
7084,28,27,31,29,115
7085,26,32,34,26,118
7086,31,26,37,44,138
7087,19,29,26,27,101
7088,45,39,39,23,146
7089,32,31,30,24,117
7090,25,28,33,42,128
7091,32,30,35,36,133
7092,41,33,34,27,135
7093,42,32,36,34,144
7094,34,36,34,27,131
7095,32,34,31,46,143
7096,29,34,26,31,120
7097,36,27,26,32,121
7098,25,30,39,29,123
7099,27,25,38,29,119
7100,23,33,35,31,122
7101,24,26,36,33,119
7102,33,29,28,33,123
7103,32,30,32,40,134
7104,30,38,35,28,131
7105,26,33,27,39,125
7106,27,34,26,20,107
7107,41,30,32,30,133
7108,25,37,41,35,138
7109,22,26,41,29,118
7110,42,28,32,31,133
7111,30,38,29,40,137
7112,38,38,32,28,136
7113,31,28,32,23,114
7114,30,21,36,39,126
7115,28,38,29,33,128
7116,37,26,31,28,122
7117,33,24,29,43,129
7118,36,31,36,40,143
7119,29,34,33,31,127
7120,34,23,22,32,111
7121,23,30,28,33,114
7122,27,32,26,33,118
7123,32,39,31,32,134
7124,38,37,29,37,141
7125,34,34,26,37,131
7126,28,34,22,34,118
7127,32,37,25,24,118
7128,32,35,29,23,119
7129,25,33,33,29,120
7130,33,40,31,31,135
7131,27,28,32,30,117
7132,29,26,25,36,116
7133,37,30,37,36,140
7134,37,35,27,29,128
7135,34,21,38,23,116
7136,31,27,34,29,121
7137,32,43,29,32,136
7138,31,39,32,25,127
7139,23,31,40,36,130
7140,39,26,25,23,113
7141,36,41,44,39,160
7142,42,34,30,26,132
7143,30,29,37,23,119
7144,25,34,30,30,119
7145,33,32,27,33,125
7146,34,34,22,28,118
7147,37,26,20,36,119
7148,45,37,34,24,140
7149,32,36,33,25,126
7150,36,21,38,24,119
7151,26,24,35,23,108
7152,39,30,30,24,123
7153,28,31,30,26,115
7154,30,29,38,27,124
7155,26,19,40,29,114
7156,24,29,30,30,113
7157,31,29,33,33,126
7158,23,34,33,27,117
7159,37,33,24,27,121
7160,29,30,34,38,131
7161,35,31,30,27,123
7162,32,30,25,34,121
7163,28,42,38,30,138
7164,29,25,34,30,118
7165,27,39,39,30,135
7166,35,40,35,27,137
7167,25,38,39,26,128
7168,36,24,30,33,123
7169,32,40,34,23,129
7170,27,35,29,27,118
7171,30,25,34,37,126
7172,43,35,20,23,121
7173,36,26,26,33,121
7174,33,30,22,30,115
7175,30,47,34,28,139
7176,32,43,33,22,130
7177,31,41,26,36,134
7178,35,26,29,31,121
7179,34,34,26,29,123
7180,28,32,21,30,111
7181,42,32,23,32,129
7182,27,33,40,29,129
7183,33,29,31,24,117
7184,26,29,27,32,114
7185,26,36,26,21,109
7186,28,38,31,28,125
7187,33,33,24,34,124
7188,32,29,37,32,130
7189,29,24,23,35,111
7190,32,42,36,27,137
7191,33,33,27,38,131
7192,34,26,24,25,109
7193,32,34,22,22,110
7194,32,34,25,30,121
7195,30,27,38,29,124
7196,29,34,26,29,118
7197,28,34,25,38,125
7198,32,39,27,28,126
7199,24,28,32,35,119
7200,30,32,43,38,143
7201,37,44,23,26,130
7202,25,38,37,30,130
7203,27,34,21,30,112
7204,37,29,21,25,112
7205,35,36,26,26,123
7206,30,32,43,30,135
7207,29,38,28,41,136
7208,30,29,22,43,124
7209,33,33,29,32,127
7210,35,21,38,35,129
7211,43,28,24,29,124
7212,28,39,29,32,128
7213,30,35,45,31,141
7214,30,40,31,36,137
7215,35,29,33,31,128
7216,24,46,38,33,141
7217,26,35,36,40,137
7218,36,31,27,32,126
7219,26,30,25,33,114
7220,36,27,29,42,134
7221,28,35,34,29,126
7222,36,32,24,36,128
7223,30,37,31,33,131
7224,38,34,30,40,142
7225,27,22,31,37,117
7226,36,29,38,34,137
7227,25,32,34,33,124
7228,30,34,34,37,135
7229,22,27,27,35,111
7230,26,36,38,32,132
7231,36,37,30,31,134
7232,25,33,36,33,127
7233,19,22,43,40,124
7234,26,22,31,29,108
7235,28,26,32,31,117
7236,35,26,26,36,123
7237,26,33,35,24,118
7238,33,32,23,28,116
7239,24,32,33,35,124
7240,30,28,25,25,108
7241,28,36,42,31,137
7242,32,19,43,32,126
7243,29,31,28,25,113
7244,30,39,29,29,127
7245,30,43,23,31,127
7246,34,28,38,23,123
7247,28,34,29,35,126
7248,26,35,36,26,123
7249,36,34,23,27,120
7250,30,34,24,29,117
7251,30,24,38,29,121
7252,23,36,31,34,124
7253,25,21,32,32,110
7254,37,28,38,28,131
7255,25,33,39,33,130
7256,24,32,23,26,105
7257,33,27,20,32,112
7258,31,33,25,30,119
7259,40,34,29,45,148
7260,30,29,42,36,137
7261,28,30,34,30,122
7262,30,39,28,27,124
7263,33,33,29,37,132
7264,24,30,27,25,106
7265,34,28,40,34,136
7266,33,30,20,38,121
7267,27,25,28,40,120
7268,29,34,28,35,126
7269,38,43,28,38,147
7270,30,34,24,28,116
7271,29,40,25,38,132
7272,32,29,32,34,127
7273,38,32,21,39,130
7274,30,30,36,20,116
7275,35,35,28,36,134
7276,31,31,31,41,134
7277,27,29,28,29,113
7278,41,34,28,23,126
7279,30,37,25,33,125
7280,30,27,27,32,116
7281,31,27,30,22,110
7282,27,28,25,33,113
7283,21,24,25,32,102
7284,35,29,30,30,124
7285,26,27,31,30,114
7286,35,29,24,28,116
7287,33,29,30,23,115
7288,31,37,29,31,128
7289,39,42,28,36,145
7290,41,29,32,34,136
7291,33,28,35,42,138
7292,28,28,36,32,124
7293,26,23,33,28,110
7294,34,32,28,36,130
7295,29,31,29,33,122
7296,34,32,30,25,121
7297,22,44,23,28,117
7298,28,35,27,31,121
7299,28,37,34,32,131
7300,30,31,34,34,129
7301,33,27,23,27,110
7302,25,37,34,39,135
7303,31,24,36,26,117
7304,31,23,40,35,129
7305,33,37,32,20,122
7306,26,22,36,30,114
7307,35,33,32,23,123
7308,33,31,26,39,129
7309,33,34,27,29,123
7310,20,36,31,29,116
7311,33,38,26,29,126
7312,41,26,45,24,136
7313,36,43,23,41,143
7314,38,31,29,37,135
7315,31,30,29,24,114
7316,32,43,33,29,137
7317,28,30,40,29,127
7318,39,26,40,28,133
7319,38,31,24,29,122
7320,28,21,34,26,109
7321,26,26,33,26,111
7322,42,20,26,31,119
7323,28,32,27,24,111
7324,33,48,31,31,143
7325,20,30,32,50,132
7326,38,34,30,35,137
7327,29,29,31,30,119
7328,32,26,34,32,124
7329,42,28,33,22,125
7330,41,23,30,32,126
7331,28,26,27,38,119
7332,27,25,27,34,113
7333,27,26,41,24,118
7334,41,29,31,29,130
7335,23,35,41,44,143
7336,29,29,35,39,132
7337,35,36,23,30,124
7338,35,31,36,38,140
7339,29,24,34,31,118
7340,33,31,34,27,125
7341,30,24,27,23,104
7342,37,35,26,43,141
7343,27,25,48,33,133
7344,35,30,31,39,135
7345,38,38,16,27,119
7346,28,35,36,26,125
7347,37,36,24,36,133
7348,30,30,24,22,106
7349,36,33,30,31,130
7350,32,36,29,34,131
7351,34,35,32,36,137
7352,25,33,41,41,140
7353,28,29,25,28,110
7354,27,42,28,32,129
7355,27,37,24,31,119
7356,26,21,32,31,110
7357,22,34,44,34,134
7358,33,28,38,28,127
7359,28,35,19,39,121
7360,31,41,43,26,141
7361,29,29,29,27,114
7362,33,22,22,32,109
7363,25,31,42,32,130
7364,24,42,35,31,132
7365,28,30,37,27,122
7366,30,38,37,24,129
7367,42,25,43,26,136
7368,34,30,30,29,123
7369,28,33,31,25,117
7370,37,39,38,28,142
7371,36,22,31,32,121
7372,33,21,42,28,124
7373,26,25,38,39,128
7374,22,28,35,30,115
7375,29,36,29,35,129
7376,32,33,31,30,126
7377,36,37,31,28,132
7378,26,31,33,32,122
7379,13,32,28,36,109
7380,24,41,30,37,132
7381,32,22,41,36,131
7382,29,34,33,31,127
7383,36,33,30,38,137
7384,34,37,25,36,132
7385,33,33,23,23,112
7386,27,41,33,21,122
7387,25,36,29,36,126
7388,31,25,28,28,112
7389,27,24,29,33,113
7390,27,31,29,34,121
7391,30,45,27,31,133
7392,34,34,35,38,141
7393,33,28,20,21,102
7394,34,32,31,35,132
7395,35,30,29,27,121
7396,35,26,34,32,127
7397,36,28,33,29,126
7398,27,28,32,32,119
7399,28,36,29,30,123
7400,32,31,28,28,119
7401,35,34,28,26,123
7402,23,23,27,33,106
7403,30,27,31,22,110
7404,27,37,27,26,117
7405,33,19,25,43,120
7406,30,26,26,37,119
7407,36,28,28,33,125
7408,38,33,21,29,121
7409,37,31,31,36,135
7410,20,41,34,30,125
7411,34,22,30,30,116
7412,28,20,37,38,123
7413,26,30,36,26,118
7414,32,39,39,23,133
7415,34,28,40,33,135
7416,23,36,38,39,136
7417,25,35,31,31,122
7418,23,33,28,35,119
7419,33,41,26,33,133
7420,37,31,39,27,134
7421,31,27,37,34,129
7422,29,22,28,26,105
7423,25,26,30,36,117
7424,34,27,34,37,132
7425,39,32,35,32,138
7426,31,27,32,22,112
7427,23,37,36,29,125
7428,34,33,26,27,120
7429,32,33,38,29,132
7430,35,35,27,41,138
7431,33,30,31,25,119
7432,34,34,22,24,114
7433,36,38,22,33,129
7434,35,36,28,32,131
7435,24,39,29,29,121
7436,41,32,35,29,137
7437,27,25,25,35,112
7438,25,24,32,27,108
7439,29,28,33,36,126
7440,29,33,32,32,126
7441,32,26,47,27,132
7442,35,23,39,35,132
7443,36,24,36,35,131
7444,25,35,30,32,122
7445,37,37,24,32,130
7446,30,21,36,40,127
7447,27,21,25,27,100
7448,35,43,38,25,141
7449,34,25,29,27,115
7450,32,39,35,33,139
7451,40,30,31,39,140
7452,34,24,35,26,119
7453,30,31,27,30,118
7454,32,33,34,26,125
7455,34,31,38,27,130
7456,28,36,31,33,128
7457,26,30,31,32,119
7458,39,25,28,32,124
7459,31,36,28,35,130
7460,29,32,21,36,118
7461,30,29,33,39,131
7462,28,31,36,36,131
7463,38,21,34,36,129
7464,27,34,33,39,133
7465,29,25,21,36,111
7466,30,32,29,40,131
7467,37,28,27,27,119
7468,38,36,36,39,149
7469,34,29,32,32,127
7470,40,35,24,30,129
7471,32,36,39,33,140
7472,37,39,41,35,152
7473,30,31,22,31,114
7474,23,33,37,27,120
7475,29,43,23,37,132
7476,27,43,26,29,125
7477,37,27,32,33,129
7478,32,31,33,29,125
7479,30,20,32,25,107
7480,35,26,34,27,122
7481,32,22,28,25,107
7482,37,24,38,29,128
7483,32,22,25,38,117
7484,40,31,40,25,136
7485,39,29,36,34,138
7486,33,37,30,24,124
7487,28,26,37,32,123
7488,31,39,30,37,137
7489,29,35,25,43,132
7490,36,41,26,38,141
7491,30,31,32,28,121
7492,33,33,21,23,110
7493,42,29,38,26,135
7494,40,29,32,30,131
7495,38,34,17,28,117
7496,35,33,29,30,127
7497,35,28,28,40,131
7498,32,41,34,22,129
7499,35,28,36,26,125
7500,25,35,34,32,126
7501,24,28,38,35,125
7502,24,34,29,27,114
7503,33,22,23,37,115
7504,27,35,23,26,111
7505,42,31,34,38,145
7506,28,33,34,29,124
7507,29,22,39,26,116
7508,34,29,28,30,121
7509,34,21,24,28,107
7510,25,34,29,34,122
7511,29,33,36,33,131
7512,32,21,32,28,113
7513,36,43,36,23,138
7514,26,40,28,37,131
7515,30,28,31,32,121
7516,31,30,30,27,118
7517,31,35,45,31,142
7518,32,30,43,25,130
7519,35,30,32,35,132
7520,32,30,35,23,120
7521,31,30,30,32,123
7522,19,21,29,35,104
7523,22,28,28,36,114
7524,23,38,29,31,121
7525,38,25,30,32,125
7526,26,45,37,25,133
7527,28,32,43,26,129
7528,30,33,36,28,127
7529,23,36,31,32,122
7530,23,30,29,26,108
7531,39,41,22,30,132
7532,27,28,32,39,126
7533,37,30,34,26,127
7534,31,19,39,41,130
7535,33,44,38,29,144
7536,35,27,31,31,124
7537,31,38,27,25,121
7538,35,36,23,33,127
7539,35,30,32,35,132
7540,27,38,33,25,123
7541,34,24,29,32,119
7542,28,31,25,34,118
7543,32,26,28,39,125
7544,29,32,38,27,126
7545,26,37,28,25,116
7546,24,46,37,24,131
7547,25,25,33,22,105
7548,23,31,38,33,125
7549,34,31,34,29,128
7550,32,27,29,30,118
7551,22,37,25,36,120
7552,37,24,29,34,124
7553,21,29,36,30,116
7554,31,29,35,33,128
7555,34,29,28,42,133
7556,29,35,25,30,119
7557,38,42,32,25,137
7558,35,35,31,22,123
7559,20,37,34,27,118
7560,37,33,36,36,142
7561,29,33,28,23,113
7562,30,26,32,29,117
7563,26,34,41,33,134
7564,30,27,32,33,122
7565,42,34,34,22,132
7566,30,23,38,31,122
7567,30,23,29,32,114
7568,37,29,31,28,125
7569,26,31,28,29,114
7570,24,33,38,25,120
7571,27,33,29,37,126
7572,25,21,38,27,111
7573,43,28,21,39,131
7574,38,20,24,33,115
7575,37,34,32,37,140
7576,25,29,38,28,120
7577,35,23,29,29,116
7578,25,27,44,33,129
7579,28,35,32,38,133
7580,28,39,33,27,127
7581,27,38,37,32,134
7582,26,33,26,32,117
7583,31,25,25,29,110
7584,28,32,40,34,134
7585,36,35,27,36,134
7586,26,18,27,36,107
7587,29,37,29,32,127
7588,25,48,33,36,142
7589,37,32,26,33,128
7590,42,26,34,25,127
7591,24,33,38,31,126
7592,31,32,28,32,123
7593,30,24,33,31,118
7594,24,27,32,27,110
7595,23,30,37,29,119
7596,26,28,24,37,115
7597,28,31,26,41,126
7598,34,29,36,16,115
7599,28,24,27,29,108
7600,31,32,35,25,123
7601,23,31,31,32,117
7602,29,31,29,35,124
7603,35,39,26,29,129
7604,27,33,29,34,123
7605,30,26,28,30,114
7606,28,27,29,27,111
7607,33,29,30,31,123
7608,34,24,36,28,122
7609,26,41,27,29,123
7610,31,30,30,39,130
7611,33,26,22,35,116
7612,26,31,29,36,122
7613,28,35,32,30,125
7614,25,35,32,27,119
7615,34,29,35,32,130
7616,27,32,24,39,122
7617,25,32,29,35,121
7618,34,31,38,26,129
7619,30,28,16,37,111
7620,35,31,26,26,118
7621,26,29,30,32,117
7622,38,34,32,28,132
7623,37,31,25,31,124
7624,30,29,33,30,122
7625,30,30,35,21,116
7626,23,31,37,42,133
7627,48,29,35,26,138
7628,38,28,30,43,139
7629,34,45,28,22,129
7630,29,38,30,32,129
7631,34,29,28,26,117
7632,26,25,36,29,116
7633,30,30,23,32,115
7634,21,32,31,26,110
7635,32,22,30,23,107
7636,35,31,26,27,119
7637,38,28,21,29,116
7638,26,30,30,37,123
7639,27,24,29,25,105
7640,26,31,39,32,128
7641,36,30,33,23,122
7642,35,23,29,24,111
7643,28,35,35,31,129
7644,24,37,34,25,120
7645,26,32,28,36,122
7646,35,37,26,27,125
7647,31,30,37,23,121
7648,27,37,43,38,145
7649,30,28,26,20,104
7650,29,39,25,31,124
7651,36,35,22,29,122
7652,28,34,23,26,111
7653,38,34,25,24,121
7654,24,35,38,34,131
7655,23,27,34,32,116
7656,28,23,34,33,118
7657,35,27,31,38,131
7658,40,29,29,32,130
7659,28,29,26,25,108
7660,23,39,32,24,118
7661,27,40,32,20,119
7662,34,33,25,35,127
7663,25,25,27,26,103
7664,37,26,25,25,113
7665,26,29,24,28,107
7666,29,25,32,32,118
7667,30,30,31,32,123
7668,38,30,23,30,121
7669,25,28,30,35,118
7670,29,29,37,25,120
7671,34,34,40,34,142
7672,25,29,31,17,102
7673,29,30,30,24,113
7674,30,39,29,27,125
7675,24,26,31,36,117
7676,29,37,26,33,125
7677,36,30,34,35,135
7678,27,26,35,36,124
7679,29,24,27,23,103
7680,26,36,35,27,124
7681,34,34,28,33,129
7682,40,43,23,22,128
7683,31,35,27,29,122
7684,26,27,30,24,107
7685,29,27,31,31,118
7686,31,28,28,24,111
7687,27,41,30,32,130
7688,35,22,28,29,114
7689,34,31,37,29,131
7690,29,32,31,34,126
7691,27,40,22,21,110
7692,31,30,36,25,122
7693,38,34,19,31,122
7694,36,34,22,29,121
7695,26,28,36,32,122
7696,28,27,30,36,121
7697,34,29,30,30,123
7698,35,28,25,46,134
7699,24,40,26,39,129
7700,28,32,34,34,128
7701,36,29,35,33,133
7702,37,31,35,27,130
7703,35,29,30,37,131
7704,40,35,22,25,122
7705,30,36,29,38,133
7706,27,24,36,35,122
7707,41,26,35,31,133
7708,31,33,40,28,132
7709,26,31,23,35,115
7710,31,25,34,31,121
7711,31,34,26,32,123
7712,33,23,32,20,108
7713,19,33,33,25,110
7714,31,35,29,38,133
7715,24,25,29,24,102
7716,38,37,31,34,140
7717,33,29,32,24,118
7718,26,35,28,23,112
7719,25,38,31,27,121
7720,19,33,29,39,120
7721,26,42,33,30,131
7722,37,35,36,23,131
7723,29,24,32,33,118
7724,25,38,39,28,130
7725,21,31,33,23,108
7726,26,35,44,34,139
7727,25,24,22,38,109
7728,26,30,35,23,114
7729,31,35,34,31,131
7730,31,27,18,25,101
7731,40,39,32,23,134
7732,29,32,41,29,131
7733,28,29,21,39,117
7734,35,29,30,30,124
7735,24,39,37,30,130
7736,23,32,30,24,109
7737,29,40,33,32,134
7738,25,28,31,35,119
7739,28,29,19,35,111
7740,26,28,27,36,117
7741,26,33,37,28,124
7742,28,25,28,24,105
7743,30,27,37,31,125
7744,33,35,30,34,132
7745,27,31,43,32,133
7746,25,42,26,31,124
7747,29,33,30,32,124
7748,21,38,33,35,127
7749,17,37,38,13,105
7750,39,38,40,32,149
7751,47,25,30,34,136
7752,30,24,38,31,123
7753,33,26,30,31,120
7754,38,32,28,34,132
7755,32,28,35,35,130
7756,40,23,31,32,126
7757,20,31,31,39,121
7758,43,27,31,27,128
7759,32,39,34,27,132
7760,24,32,37,33,126
7761,31,26,31,37,125
7762,21,29,35,34,119
7763,30,29,25,26,110
7764,37,28,34,30,129
7765,33,34,46,28,141
7766,40,42,22,34,138
7767,22,29,32,21,104
7768,32,26,29,30,117
7769,34,27,33,38,132
7770,25,35,32,23,115
7771,30,40,26,31,127
7772,27,25,24,28,104
7773,21,43,33,25,122
7774,22,19,36,22,99
7775,36,28,25,31,120
7776,26,27,31,18,102
7777,29,31,34,31,125
7778,28,35,31,33,127
7779,38,32,36,27,133
7780,30,32,33,28,123
7781,26,25,33,37,121
7782,30,27,32,28,117
7783,28,28,30,25,111
7784,31,29,33,17,110
7785,32,30,28,31,121
7786,29,41,33,35,138
7787,35,31,37,28,131
7788,38,30,28,27,123
7789,36,32,20,27,115
7790,36,32,36,33,137
7791,21,30,29,36,116
7792,37,29,34,29,129
7793,32,37,33,20,122
7794,33,28,23,38,122
7795,23,26,37,25,111
7796,32,28,24,32,116
7797,21,40,28,41,130
7798,30,28,39,28,125
7799,39,21,40,25,125
7800,24,37,32,31,124
7801,24,28,44,25,121
7802,32,37,33,29,131
7803,32,33,30,38,133
7804,30,29,30,27,116
7805,29,25,23,35,112
7806,29,33,32,33,127
7807,31,32,30,36,129
7808,21,34,27,30,112
7809,48,22,36,33,139
7810,31,17,36,40,124
7811,33,37,32,29,131
7812,29,37,28,28,122
7813,24,49,35,29,137
7814,33,44,31,32,140
7815,29,33,28,25,115
7816,27,39,31,31,128
7817,31,35,35,25,126
7818,24,31,28,35,118
7819,34,26,31,30,121
7820,31,29,27,39,126
7821,23,30,32,30,115
7822,30,34,34,33,131
7823,27,29,25,30,111
7824,36,40,36,29,141
7825,24,26,34,30,114
7826,29,23,38,38,128
7827,36,26,31,37,130
7828,40,34,27,34,135
7829,29,41,27,37,134
7830,43,36,23,36,138
7831,23,26,29,29,107
7832,28,39,30,31,128
7833,31,38,37,30,136
7834,47,29,32,29,137
7835,23,37,35,38,133
7836,21,32,23,34,110
7837,36,29,35,31,131
7838,27,31,31,35,124
7839,34,32,34,30,130
7840,30,32,24,30,116
7841,24,25,33,38,120
7842,27,32,30,37,126
7843,34,39,35,30,138
7844,37,37,33,26,133
7845,34,34,33,25,126
7846,39,33,33,29,134
7847,31,34,27,35,127
7848,33,28,31,33,125
7849,22,30,35,32,119
7850,31,30,40,40,141
7851,29,33,35,33,130
7852,19,25,34,21,99
7853,29,22,33,20,104
7854,30,35,32,24,121
7855,31,25,35,28,119
7856,27,29,29,20,105
7857,30,34,39,25,128
7858,25,30,37,27,119
7859,32,25,30,30,117
7860,20,26,19,33,98
7861,30,36,24,29,119
7862,36,39,34,21,130
7863,19,37,44,41,141
7864,31,30,28,40,129
7865,37,33,22,32,124
7866,28,40,41,34,143
7867,29,36,31,23,119
7868,40,29,31,32,132
7869,28,27,34,30,119
7870,30,40,27,42,139
7871,34,29,31,41,135
7872,39,26,29,28,122
7873,23,36,24,32,115
7874,38,35,38,31,142
7875,39,29,26,27,121
7876,38,33,30,37,138
7877,31,27,30,30,118
7878,23,34,25,27,109
7879,28,33,34,29,124
7880,22,33,32,29,116
7881,38,31,35,28,132
7882,27,28,23,31,109
7883,20,38,37,28,123
7884,30,28,23,36,117
7885,38,27,34,35,134
7886,31,28,33,33,125
7887,36,23,30,22,111
7888,38,22,34,28,122
7889,31,41,35,27,134
7890,35,25,29,41,130
7891,29,25,26,29,109
7892,34,31,26,32,123
7893,28,31,32,38,129
7894,45,29,37,29,140
7895,22,36,41,35,134
7896,30,38,30,27,125
7897,37,32,26,30,125
7898,38,46,30,29,143
7899,32,36,31,30,129
7900,27,32,32,36,127
7901,41,27,35,36,139
7902,31,22,30,33,116
7903,27,29,29,39,124
7904,25,27,25,28,105
7905,28,41,27,42,138
7906,26,39,31,28,124
7907,23,37,30,34,124
7908,40,30,23,36,129
7909,33,21,30,26,110
7910,31,26,38,36,131
7911,37,40,29,34,140
7912,37,29,25,37,128
7913,32,28,30,34,124
7914,28,34,37,32,131
7915,29,31,25,36,121
7916,32,32,36,25,125
7917,44,28,39,29,140
7918,37,33,27,33,130
7919,33,27,29,31,120
7920,35,24,34,33,126
7921,34,25,38,29,126
7922,32,35,37,30,134
7923,35,25,24,25,109
7924,33,30,42,23,128
7925,27,35,25,40,127
7926,39,24,35,38,136
7927,36,34,38,30,138
7928,35,30,32,27,124
7929,44,28,29,33,134
7930,41,26,38,28,133
7931,23,28,30,25,106
7932,37,35,35,37,144
7933,28,28,28,29,113
7934,31,24,28,36,119
7935,34,32,29,30,125
7936,25,30,41,35,131
7937,26,39,33,32,130
7938,33,41,31,26,131
7939,37,34,33,30,134
7940,27,32,32,30,121
7941,43,29,31,30,133
7942,28,33,36,35,132
7943,32,34,29,38,133
7944,35,38,21,37,131
7945,33,30,34,36,133
7946,35,38,26,32,131
7947,35,22,34,24,115
7948,28,36,34,26,124
7949,25,34,35,40,134
7950,29,38,31,31,129
7951,25,34,38,36,133
7952,20,22,32,35,109
7953,40,33,27,21,121
7954,34,38,39,38,149
7955,30,34,29,24,117
7956,24,31,25,37,117
7957,23,39,37,35,134
7958,31,36,24,20,111
7959,31,23,35,29,118
7960,31,30,42,26,129
7961,35,34,26,30,125
7962,32,32,22,28,114
7963,31,29,35,32,127
7964,30,35,25,35,125
7965,33,33,39,38,143
7966,27,34,26,31,118
7967,34,34,33,27,128
7968,22,31,37,31,121
7969,33,24,28,32,117
7970,36,28,35,22,121
7971,31,27,36,30,124
7972,28,44,28,23,123
7973,32,29,32,36,129
7974,33,31,34,28,126
7975,30,28,29,20,107
7976,36,36,20,25,117
7977,30,30,33,28,121
7978,32,37,32,28,129
7979,28,24,33,25,110
7980,33,34,23,33,123
7981,36,37,39,32,144
7982,33,34,31,33,131
7983,31,37,29,24,121
7984,25,33,17,23,98
7985,34,33,31,23,121
7986,37,37,33,30,137
7987,37,24,32,28,121
7988,29,30,27,33,119
7989,28,36,35,28,127
7990,29,34,23,34,120
7991,27,45,44,30,146
7992,23,33,30,22,108
7993,37,24,25,40,126
7994,30,32,30,26,118
7995,37,33,25,41,136
7996,35,43,31,28,137
7997,32,31,22,30,115
7998,32,35,27,43,137
7999,30,23,31,35,119
8000,40,27,29,27,123
8001,32,29,33,22,116
8002,35,30,28,46,139
8003,22,32,29,45,128
8004,35,34,27,38,134
8005,26,28,41,31,126
8006,33,30,41,33,137
8007,35,39,31,29,134
8008,28,30,28,28,114
8009,33,37,32,29,131
8010,28,22,43,27,120
8011,22,36,22,39,119
8012,27,24,40,35,126
8013,35,31,26,27,119
8014,33,27,28,29,117
8015,28,27,29,28,112
8016,21,31,31,30,113
8017,34,34,19,21,108
8018,32,36,27,31,126
8019,34,26,23,26,109
8020,19,32,32,27,110
8021,35,26,31,29,121
8022,30,22,38,26,116
8023,31,34,28,31,124
8024,36,34,31,28,129
8025,43,32,22,25,122
8026,37,32,35,35,139
8027,42,33,33,34,142
8028,29,25,35,25,114
8029,22,27,28,34,111
8030,27,27,28,27,109
8031,33,41,28,31,133
8032,33,44,30,28,135
8033,14,34,44,40,132
8034,35,36,27,22,120
8035,24,34,26,36,120
8036,25,31,41,35,132
8037,35,24,36,32,127
8038,26,30,35,43,134
8039,33,34,41,23,131
8040,37,37,25,27,126
8041,30,34,37,29,130
8042,34,43,36,31,144
8043,32,23,41,38,134
8044,30,32,32,34,128
8045,31,29,24,31,115
8046,28,35,28,32,123
8047,30,23,34,34,121
8048,27,26,37,24,114
8049,33,40,31,34,138
8050,28,34,31,33,126
8051,31,33,39,31,134
8052,25,28,36,29,118
8053,19,36,32,31,118
8054,37,36,33,37,143
8055,39,25,24,32,120
8056,36,25,36,30,127
8057,28,34,33,31,126
8058,32,28,33,28,121
8059,31,32,43,33,139
8060,30,31,42,28,131
8061,35,29,36,24,124
8062,38,31,33,27,129
8063,34,28,30,23,115
8064,32,32,27,29,120
8065,41,26,42,38,147
8066,23,29,31,40,123
8067,34,23,32,38,127
8068,26,35,34,32,127
8069,37,35,33,31,136
8070,31,29,32,31,123
8071,26,34,26,23,109
8072,27,29,26,33,115
8073,35,22,26,23,106
8074,26,38,36,41,141
8075,28,41,33,32,134
8076,35,28,39,29,131
8077,24,33,26,37,120
8078,32,26,30,26,114
8079,28,26,37,32,123
8080,35,41,30,30,136
8081,29,34,26,41,130
8082,24,29,30,36,119
8083,38,31,27,25,121
8084,23,35,31,29,118
8085,38,26,16,37,117
8086,37,24,33,30,124
8087,35,28,31,35,129
8088,34,26,40,42,142
8089,25,33,20,31,109
8090,28,31,39,32,130
8091,29,29,38,31,127
8092,22,23,31,36,112
8093,27,31,34,30,122
8094,31,26,25,30,112
8095,40,22,33,31,126
8096,36,22,32,37,127
8097,32,27,35,41,135
8098,33,35,41,27,136
8099,32,36,25,22,115
8100,29,43,38,35,145
8101,30,23,30,26,109
8102,34,31,26,34,125
8103,27,31,34,21,113
8104,27,33,34,28,122
8105,32,32,30,24,118
8106,22,31,34,36,123
8107,27,29,54,37,147
8108,22,31,31,31,115
8109,23,31,39,40,133
8110,28,27,27,36,118
8111,34,36,32,28,130
8112,28,29,44,35,136
8113,35,31,27,31,124
8114,33,28,42,40,143
8115,33,28,23,41,125
8116,27,44,28,26,125
8117,36,29,28,26,119
8118,35,30,31,34,130
8119,30,32,36,26,124
8120,26,34,28,35,123
8121,33,36,32,28,129
8122,32,39,24,32,127
8123,26,20,21,28,95
8124,40,35,32,37,144
8125,40,33,42,32,147
8126,24,26,23,24,97
8127,35,28,15,35,113
8128,33,31,24,36,124
8129,31,29,35,26,121
8130,32,33,34,39,138
8131,26,40,34,38,138
8132,24,24,30,29,107
8133,40,30,39,31,140
8134,30,24,33,27,114
8135,22,34,37,25,118
8136,39,27,35,35,136
8137,38,33,30,32,133
8138,26,36,24,23,109
8139,44,38,22,30,134
8140,29,29,29,22,109
8141,32,28,24,38,122
8142,28,33,34,27,122
8143,29,28,29,26,112
8144,37,26,24,33,120
8145,31,35,33,27,126
8146,38,28,30,29,125
8147,31,34,37,32,134
8148,26,36,28,25,115
8149,31,35,37,30,133
8150,36,35,29,31,131
8151,33,37,27,36,133
8152,27,31,29,26,113
8153,29,34,33,33,129
8154,27,31,30,26,114
8155,40,27,35,23,125
8156,33,25,32,38,128
8157,29,36,22,33,120
8158,32,28,32,30,122
8159,27,36,34,33,130
8160,31,30,31,35,127
8161,27,40,35,34,136
8162,35,30,42,22,129
8163,35,23,27,27,112
8164,29,36,25,36,126
8165,37,25,34,24,120
8166,30,34,30,30,124
8167,33,35,38,24,130
8168,26,45,33,26,130
8169,29,38,23,22,112
8170,30,37,37,29,133
8171,34,24,38,34,130
8172,27,33,24,21,105
8173,26,40,30,31,127
8174,26,27,37,28,118
8175,27,39,33,34,133
8176,28,27,43,25,123
8177,27,34,32,34,127
8178,40,22,22,23,107
8179,27,30,38,28,123
8180,19,28,32,41,120
8181,39,29,34,36,138
8182,34,31,26,21,112
8183,21,42,33,34,130
8184,34,29,24,36,123
8185,25,27,30,31,113
8186,28,31,30,25,114
8187,20,29,39,24,112
8188,27,43,36,38,144
8189,39,32,37,29,137
8190,31,27,30,44,132
8191,29,34,35,35,133
8192,31,27,31,35,124
8193,25,27,30,32,114
8194,19,34,25,29,107
8195,31,26,33,22,112
8196,40,31,35,29,135
8197,27,32,29,34,122
8198,30,31,28,44,133
8199,33,27,20,32,112
8200,33,23,26,28,110
8201,40,28,24,37,129
8202,30,27,40,38,135
8203,37,29,31,29,126
8204,36,27,27,29,119
8205,24,44,37,25,130
8206,27,26,27,23,103
8207,45,30,33,38,146
8208,35,37,30,30,132
8209,37,26,30,22,115
8210,32,38,23,32,125
8211,39,26,23,32,120
8212,35,28,33,29,125
8213,27,36,29,30,122
8214,25,37,29,27,118
8215,35,42,27,21,125
8216,26,27,44,33,130
8217,32,20,32,33,117
8218,26,32,48,30,136
8219,25,34,28,34,121
8220,44,27,26,35,132
8221,21,29,34,33,117
8222,30,34,35,43,142
8223,27,22,33,33,115
8224,29,34,28,31,122
8225,35,27,40,32,134
8226,36,26,38,35,135
8227,31,26,40,29,126
8228,38,37,34,30,139
8229,29,37,33,30,129
8230,33,29,26,24,112
8231,38,24,26,30,118
8232,25,34,33,28,120
8233,47,32,27,31,137
8234,37,22,32,41,132
8235,27,27,38,40,132
8236,29,30,36,36,131
8237,26,19,37,35,117
8238,23,31,28,28,110
8239,32,37,26,23,118
8240,37,26,24,34,121
8241,35,41,29,22,127
8242,20,37,26,36,119
8243,30,35,22,30,117
8244,25,25,21,27,98
8245,29,33,22,41,125
8246,31,29,28,30,118
8247,35,36,27,38,136
8248,29,29,29,35,122
8249,30,29,41,32,132
8250,28,32,29,32,121
8251,31,30,26,32,119
8252,33,25,21,25,104
8253,32,36,34,32,134
8254,26,29,32,25,112
8255,28,37,36,35,136
8256,35,35,39,26,135
8257,25,29,35,37,126
8258,29,30,41,36,136
8259,29,25,35,35,124
8260,29,23,31,39,122
8261,30,23,35,27,115
8262,32,32,27,31,122
8263,34,29,27,28,118
8264,43,23,31,33,130
8265,40,36,26,25,127
8266,29,29,41,25,124
8267,36,35,25,24,120
8268,21,26,35,26,108
8269,24,27,39,38,128
8270,18,31,34,33,116
8271,29,32,28,38,127
8272,26,32,23,31,112
8273,29,20,31,35,115
8274,35,33,41,33,142
8275,38,25,21,27,111
8276,30,27,32,42,131
8277,34,42,36,36,148
8278,31,30,35,32,128
8279,28,31,33,36,128
8280,32,44,29,23,128
8281,21,38,47,26,132
8282,39,17,34,27,117
8283,38,23,29,31,121
8284,32,20,28,39,119
8285,24,22,32,30,108
8286,40,33,26,29,128
8287,37,27,26,27,117
8288,28,31,39,36,134
8289,28,26,30,33,117
8290,34,33,28,29,124
8291,30,36,23,47,136
8292,31,31,32,28,122
8293,35,34,26,30,125
8294,26,24,35,38,123
8295,28,30,28,33,119
8296,28,31,24,28,111
8297,40,29,40,32,141
8298,37,39,30,32,138
8299,26,29,35,39,129
8300,31,33,31,27,122
8301,27,38,23,48,136
8302,37,31,29,26,123
8303,33,27,33,26,119
8304,19,27,30,35,111
8305,33,43,26,29,131
8306,29,23,36,26,114
8307,37,34,34,29,134
8308,23,34,25,28,110
8309,33,30,23,42,128
8310,38,24,34,34,130
8311,34,32,26,29,121
8312,37,27,24,31,119
8313,41,37,36,31,145
8314,34,33,23,28,118
8315,32,32,33,33,130
8316,25,21,32,25,103
8317,33,28,27,32,120
8318,32,37,31,33,133
8319,33,27,26,43,129
8320,25,26,44,20,115
8321,37,36,29,31,133
8322,28,28,30,28,114
8323,30,28,26,27,111
8324,26,30,35,36,127
8325,32,29,30,36,127
8326,28,35,39,31,133
8327,36,21,38,36,131
8328,44,32,14,27,117
8329,33,29,17,41,120
8330,32,31,38,38,139
8331,38,32,27,33,130
8332,28,29,31,42,130
8333,32,36,29,36,133
8334,35,27,31,35,128
8335,34,34,21,38,127
8336,34,32,28,29,123
8337,28,23,30,36,117
8338,32,35,20,30,117
8339,35,33,30,37,135
8340,33,31,30,44,138
8341,24,33,30,34,121
8342,39,24,36,26,125
8343,47,51,25,24,147
8344,29,35,35,32,131
8345,28,29,14,32,103
8346,29,32,34,33,128
8347,28,33,30,42,133
8348,36,24,33,31,124
8349,29,32,27,30,118
8350,35,28,26,33,122
8351,35,26,32,29,122
8352,46,37,35,23,141
8353,37,33,29,25,124
8354,28,32,27,29,116
8355,37,24,40,39,140
8356,32,25,30,24,111
8357,29,25,25,24,103
8358,28,26,31,23,108
8359,30,32,32,28,122
8360,28,29,31,29,117
8361,39,23,27,27,116
8362,29,36,39,24,128
8363,33,38,29,25,125
8364,31,36,20,39,126
8365,22,28,41,34,125
8366,30,39,32,32,133
8367,26,35,34,39,134
8368,43,33,24,29,129
8369,39,25,40,36,140
8370,26,31,39,33,129
8371,40,29,25,36,130
8372,37,30,27,29,123
8373,26,31,23,37,117
8374,22,29,31,33,115
8375,29,40,27,27,123
8376,37,24,33,19,113
8377,38,26,29,32,125
8378,22,28,29,36,115
8379,28,30,32,34,124
8380,25,34,35,37,131
8381,31,35,31,22,119
8382,27,33,31,24,115
8383,35,38,38,33,144
8384,36,27,35,30,128
8385,31,35,36,20,122
8386,37,26,27,31,121
8387,30,47,36,29,142
8388,31,27,33,27,118
8389,30,29,38,35,132
8390,19,27,34,31,111
8391,37,33,36,32,138
8392,22,42,30,29,123
8393,39,27,27,28,121
8394,38,35,31,29,133
8395,23,31,34,32,120
8396,35,26,33,37,131
8397,26,29,31,33,119
8398,32,32,32,30,126
8399,30,28,26,26,110
8400,36,26,35,35,132
8401,30,26,35,34,125
8402,34,37,35,33,139
8403,37,33,37,31,138
8404,21,34,32,23,110
8405,34,29,26,31,120
8406,31,33,46,20,130
8407,23,40,30,28,121
8408,22,36,24,31,113
8409,36,34,34,23,127
8410,33,39,25,21,118
8411,25,25,30,38,118
8412,28,32,32,33,125
8413,36,37,28,36,137
8414,35,30,30,35,130
8415,32,25,35,25,117
8416,24,43,35,28,130
8417,27,38,29,33,127
8418,28,25,38,24,115
8419,26,37,36,28,127
8420,37,30,33,25,125
8421,31,29,30,33,123
8422,28,25,25,39,117
8423,37,31,33,26,127
8424,34,28,28,23,113
8425,25,27,21,29,102
8426,25,28,34,40,127
8427,28,43,30,29,130
8428,36,43,33,33,145
8429,30,28,25,30,113
8430,31,27,28,38,124
8431,30,18,36,35,119
8432,42,35,33,33,143
8433,27,31,22,27,107
8434,33,33,24,25,115
8435,27,34,33,36,130
8436,30,30,24,27,111
8437,41,25,28,36,130
8438,32,32,33,21,118
8439,31,26,40,31,128
8440,22,43,34,35,134
8441,32,25,22,30,109
8442,34,33,26,28,121
8443,35,30,32,29,126
8444,31,23,30,23,107
8445,39,33,33,29,134
8446,26,42,43,38,149
8447,22,35,35,30,122
8448,28,27,35,35,125
8449,29,36,36,29,130
8450,33,26,33,44,136
8451,32,41,21,26,120
8452,29,37,37,34,137
8453,31,34,34,36,135
8454,34,33,28,22,117
8455,31,45,29,29,134
8456,33,39,25,28,125
8457,27,20,34,30,111
8458,36,31,33,31,131
8459,30,32,35,31,128
8460,33,21,26,29,109
8461,27,26,31,34,118
8462,24,35,27,38,124
8463,36,33,29,26,124
8464,33,36,33,29,131
8465,35,27,35,37,134
8466,25,37,26,32,120
8467,38,35,28,37,138
8468,33,29,30,37,129
8469,30,24,35,28,117
8470,33,27,35,24,119
8471,32,35,31,33,131
8472,26,43,26,31,126
8473,30,28,32,33,123
8474,35,40,23,34,132
8475,25,28,29,22,104
8476,29,31,33,29,122
8477,27,26,33,32,118
8478,41,26,29,39,135
8479,35,39,27,28,129
8480,34,32,38,30,134
8481,29,33,32,26,120
8482,31,27,34,27,119
8483,24,25,41,41,131
8484,32,24,38,33,127
8485,35,27,40,31,133
8486,33,28,38,29,128
8487,26,31,28,37,122
8488,26,33,40,27,126
8489,29,25,36,22,112
8490,43,26,25,32,126
8491,29,31,28,45,133
8492,26,34,21,42,123
8493,26,35,32,32,125
8494,33,20,31,36,120
8495,26,32,34,27,119
8496,30,38,27,39,134
8497,27,28,33,29,117
8498,27,26,39,43,135
8499,28,22,28,29,107
8500,32,25,38,38,133
8501,30,44,21,27,122
8502,30,34,34,32,130
8503,29,29,36,28,122
8504,24,26,24,26,100
8505,22,36,33,33,124
8506,32,28,24,31,115
8507,28,38,35,31,132
8508,30,37,25,32,124
8509,24,25,40,19,108
8510,24,25,22,29,100
8511,27,35,38,27,127
8512,24,34,40,28,126
8513,29,34,33,35,131
8514,34,32,36,28,130
8515,39,28,34,38,139
8516,36,41,27,33,137
8517,33,32,26,26,117
8518,27,29,30,27,113
8519,33,38,28,31,130
8520,35,33,30,29,127
8521,35,28,29,28,120
8522,30,29,28,31,118
8523,38,28,27,40,133
8524,23,32,33,29,117
8525,35,30,27,23,115
8526,29,41,26,30,126
8527,37,25,27,37,126
8528,30,32,33,17,112
8529,31,28,28,32,119
8530,38,31,34,32,135
8531,26,39,21,37,123
8532,31,24,31,38,124
8533,29,32,37,29,127
8534,32,47,39,38,156
8535,32,29,27,29,117
8536,31,29,29,25,114
8537,24,28,33,21,106
8538,30,16,31,26,103
8539,41,43,21,33,138
8540,36,30,22,25,113
8541,29,32,30,35,126
8542,30,28,39,40,137
8543,31,19,31,43,124
8544,33,23,36,32,124
8545,21,35,28,35,119
8546,29,26,32,34,121
8547,30,24,35,49,138
8548,27,38,32,29,126
8549,27,37,26,33,123
8550,34,36,31,36,137
8551,27,28,35,31,121
8552,40,27,32,34,133
8553,30,30,31,34,125
8554,38,38,24,18,118
8555,35,30,22,24,111
8556,28,29,21,32,110
8557,38,36,30,26,130
8558,22,31,18,34,105
8559,32,26,41,30,129
8560,26,34,38,24,122
8561,28,36,36,32,132
8562,36,35,17,38,126
8563,36,29,32,21,118
8564,23,32,32,26,113
8565,38,35,25,26,124
8566,33,27,35,37,132
8567,29,34,25,33,121
8568,23,42,28,28,121
8569,33,21,41,28,123
8570,39,29,35,22,125
8571,32,25,32,25,114
8572,36,29,36,35,136
8573,39,32,44,25,140
8574,33,30,27,28,118
8575,32,32,37,37,138
8576,38,26,29,34,127
8577,25,32,52,33,142
8578,27,21,27,31,106
8579,34,26,36,26,122
8580,32,34,36,30,132
8581,26,31,45,34,136
8582,31,33,35,28,127
8583,29,28,31,35,123
8584,25,30,28,37,120
8585,32,30,35,28,125
8586,26,31,28,30,115
8587,27,31,37,28,123
8588,29,32,26,28,115
8589,34,30,23,31,118
8590,34,32,28,37,131
8591,30,35,33,27,125
8592,38,25,30,34,127
8593,31,33,33,26,123
8594,35,20,31,35,121
8595,34,29,29,38,130
8596,34,26,30,26,116
8597,25,24,35,28,112
8598,36,31,24,26,117
8599,34,32,31,29,126
8600,32,27,16,35,110
8601,27,37,31,33,128
8602,36,21,31,32,120
8603,32,40,25,33,130
8604,26,30,33,33,122
8605,29,30,28,22,109
8606,35,26,35,32,128
8607,40,37,37,28,142
8608,23,43,38,26,130
8609,33,28,36,31,128
8610,32,35,32,31,130
8611,36,37,26,24,123
8612,39,27,34,33,133
8613,34,46,29,24,133
8614,30,22,36,35,123
8615,33,20,42,29,124
8616,36,29,27,32,124
8617,26,33,33,30,122
8618,26,38,43,24,131
8619,35,22,38,32,127
8620,33,37,28,33,131
8621,28,30,27,24,109
8622,25,28,39,24,116
8623,30,31,26,25,112
8624,24,32,33,25,114
8625,28,40,27,35,130
8626,24,36,34,27,121
8627,28,20,27,39,114
8628,42,28,31,34,135
8629,34,40,22,30,126
8630,30,29,25,28,112
8631,27,33,26,34,120
8632,39,39,29,26,133
8633,24,33,30,36,123
8634,28,26,32,32,118
8635,30,27,36,34,127
8636,41,33,30,34,138
8637,31,31,35,42,139
8638,36,38,28,29,131
8639,34,26,31,31,122
8640,30,31,36,28,125
8641,29,39,31,25,124
8642,44,33,27,26,130
8643,39,25,36,37,137
8644,26,34,36,26,122
8645,31,29,31,34,125
8646,34,33,38,33,138
8647,26,35,25,34,120
8648,24,26,33,22,105
8649,26,45,22,36,129
8650,29,39,25,32,125
8651,34,29,35,40,138
8652,37,35,21,28,121
8653,38,31,30,28,127
8654,35,28,24,35,122
8655,29,37,37,37,140
8656,21,35,36,32,124
8657,28,28,32,40,128
8658,23,39,35,33,130
8659,30,32,37,34,133
8660,34,43,25,22,124
8661,27,37,26,33,123
8662,36,34,30,27,127
8663,24,23,35,30,112
8664,42,33,28,22,125
8665,36,48,32,26,142
8666,33,23,25,28,109
8667,29,39,43,29,140
8668,33,37,36,27,133
8669,37,45,34,29,145
8670,33,32,30,27,122
8671,28,36,30,34,128
8672,28,29,26,40,123
8673,30,28,31,31,120
8674,31,29,28,23,111
8675,23,37,35,33,128
8676,40,28,38,36,142
8677,29,24,31,37,121
8678,33,32,31,26,122
8679,38,31,25,34,128
8680,27,32,34,28,121
8681,38,30,20,23,111
8682,36,37,38,31,142
8683,28,31,30,30,119
8684,32,29,18,30,109
8685,44,30,25,23,122
8686,31,40,26,30,127
8687,34,33,27,35,129
8688,32,30,36,36,134
8689,34,25,35,27,121
8690,35,26,23,32,116
8691,32,39,36,28,135
8692,24,29,31,32,116
8693,34,33,32,31,130
8694,31,30,33,28,122
8695,33,27,25,33,118
8696,39,32,35,31,137
8697,31,39,35,34,139
8698,28,29,34,43,134
8699,36,36,25,41,138
8700,33,33,39,34,139
8701,22,31,41,44,138
8702,31,30,27,31,119
8703,36,30,29,36,131
8704,31,37,24,33,125
8705,33,24,42,32,131
8706,37,23,37,33,130
8707,23,37,32,30,122
8708,39,35,36,32,142
8709,39,29,29,30,127
8710,30,30,24,36,120
8711,32,36,32,38,138
8712,18,21,41,19,99
8713,36,26,24,41,127
8714,33,31,27,33,124
8715,33,31,30,35,129
8716,27,27,37,32,123
8717,23,30,32,35,120
8718,26,36,43,28,133
8719,40,28,22,32,122
8720,35,23,45,28,131
8721,27,39,22,33,121
8722,28,25,28,45,126
8723,30,31,36,29,126
8724,31,34,31,28,124
8725,23,39,41,32,135
8726,25,32,30,22,109
8727,28,26,30,37,121
8728,18,35,29,26,108
8729,29,31,37,41,138
8730,39,23,36,21,119
8731,32,30,29,28,119
8732,31,34,36,33,134
8733,34,24,32,20,110
8734,35,39,35,19,128
8735,32,29,39,30,130
8736,31,35,25,32,123
8737,36,30,36,25,127
8738,32,31,30,30,123
8739,31,18,32,35,116
8740,31,30,32,36,129
8741,32,26,19,34,111
8742,34,28,35,37,134
8743,32,32,27,44,135
8744,35,34,27,23,119
8745,28,28,32,40,128
8746,31,32,30,30,123
8747,35,33,19,29,116
8748,37,34,33,25,129
8749,23,46,27,28,124
8750,41,30,33,35,139
8751,22,36,28,23,109
8752,31,24,28,37,120
8753,29,25,33,28,115
8754,31,32,24,32,119
8755,29,32,26,26,113
8756,28,41,37,36,142
8757,27,25,32,22,106
8758,40,31,24,31,126
8759,35,26,32,29,122
8760,33,29,30,33,125
8761,29,19,34,31,113
8762,32,26,24,33,115
8763,23,40,28,36,127
8764,35,35,25,28,123
8765,42,37,30,19,128
8766,27,32,32,39,130
8767,19,28,28,39,114
8768,31,30,27,34,122
8769,40,27,27,33,127
8770,28,29,35,32,124
8771,19,24,31,34,108
8772,35,32,33,26,126
8773,31,22,34,21,108
8774,29,34,41,39,143
8775,42,18,38,31,129
8776,40,35,25,32,132
8777,31,36,27,37,131
8778,28,31,28,32,119
8779,28,24,19,30,101
8780,42,40,30,27,139
8781,31,32,32,31,126
8782,29,36,25,35,125
8783,28,28,31,29,116
8784,30,28,27,29,114
8785,27,42,37,31,137
8786,25,33,32,32,122
8787,28,36,23,33,120
8788,29,27,28,22,106
8789,35,30,42,24,131
8790,27,25,22,27,101
8791,32,24,33,39,128
8792,27,26,30,37,120
8793,29,35,34,40,138
8794,39,30,28,32,129
8795,37,31,34,31,133
8796,38,33,24,32,127
8797,37,31,34,28,130
8798,36,33,30,24,123
8799,25,38,23,27,113
8800,35,33,42,22,132
8801,29,30,32,37,128
8802,35,38,26,32,131
8803,29,26,35,35,125
8804,25,36,30,20,111
8805,20,38,27,27,112
8806,29,41,23,32,125
8807,39,36,30,28,133
8808,34,21,26,27,108
8809,33,33,34,23,123
8810,26,28,37,35,126
8811,32,30,27,36,125
8812,26,35,33,29,123
8813,32,28,29,29,118
8814,35,26,37,26,124
8815,28,35,31,28,122
8816,43,29,40,28,140
8817,30,33,35,30,128
8818,29,24,30,29,112
8819,27,23,31,26,107
8820,36,28,31,35,130
8821,30,29,31,32,122
8822,28,28,43,26,125
8823,19,33,30,44,126
8824,24,25,32,28,109
8825,31,27,32,27,117
8826,29,29,36,22,116
8827,22,29,35,32,118
8828,31,32,32,30,125
8829,44,28,21,40,133
8830,21,35,30,30,116
8831,24,29,32,33,118
8832,32,34,27,35,128
8833,30,28,34,20,112
8834,34,37,31,29,131
8835,34,29,31,33,127
8836,34,41,33,28,136
8837,28,33,34,29,124
8838,38,30,38,27,133
8839,34,9,35,29,107
8840,30,35,42,26,133
8841,31,24,32,29,116
8842,32,29,30,33,124
8843,29,36,40,30,135
8844,40,37,23,29,129
8845,29,29,43,32,133
8846,31,32,31,33,127
8847,35,31,22,26,114
8848,30,29,34,33,126
8849,34,26,37,31,128
8850,35,33,34,36,138
8851,28,37,29,28,122
8852,29,29,44,29,131
8853,30,35,33,27,125
8854,36,30,37,29,132
8855,25,41,29,38,133
8856,30,40,37,20,127
8857,34,33,27,37,131
8858,26,41,34,36,137
8859,28,36,29,42,135
8860,30,30,36,30,126
8861,32,26,36,34,128
8862,36,35,37,31,139
8863,27,33,31,32,123
8864,34,32,30,21,117
8865,33,41,25,40,139
8866,29,44,34,33,140
8867,36,25,53,37,151
8868,30,27,31,32,120
8869,24,26,50,19,119
8870,27,23,34,24,108
8871,26,31,37,28,122
8872,23,26,34,28,111
8873,35,32,36,28,131
8874,32,41,28,31,132
8875,35,37,21,30,123
8876,38,25,28,31,122
8877,34,37,24,32,127
8878,40,33,29,35,137
8879,31,30,30,33,124
8880,33,23,35,28,119
8881,39,35,32,36,142
8882,37,40,25,25,127
8883,29,32,26,26,113
8884,27,33,37,32,129
8885,40,27,35,28,130
8886,32,36,41,30,139
8887,35,33,31,33,132
8888,33,31,31,38,133
8889,27,40,20,44,131
8890,34,31,25,21,111
8891,34,41,24,40,139
8892,31,37,36,39,143
8893,40,29,32,33,134
8894,34,29,36,26,125
8895,30,33,28,28,119
8896,39,24,21,27,111
8897,30,29,28,44,131
8898,32,34,25,25,116
8899,21,32,36,37,126
8900,31,44,25,30,130
8901,32,25,35,33,125
8902,44,25,38,24,131
8903,24,36,33,21,114
8904,40,33,29,30,132
8905,41,35,28,30,134
8906,22,41,49,33,145
8907,30,41,28,33,132
8908,25,31,20,40,116
8909,32,35,27,35,129
8910,30,42,26,28,126
8911,23,27,31,35,116
8912,32,32,30,29,123
8913,27,29,38,34,128
8914,38,23,31,35,127
8915,28,33,38,40,139
8916,34,28,39,31,132
8917,34,34,38,35,141
8918,34,34,30,27,125
8919,35,29,35,33,132
8920,33,37,22,27,119
8921,36,32,31,20,119
8922,39,30,33,24,126
8923,35,42,29,27,133
8924,28,36,31,38,133
8925,30,33,25,26,114
8926,33,25,30,35,123
8927,34,24,28,22,108
8928,29,20,35,36,120
8929,24,33,42,25,124
8930,40,26,31,32,129
8931,31,22,37,30,120
8932,34,36,31,28,129
8933,32,32,37,25,126
8934,29,27,43,29,128
8935,32,35,31,29,127
8936,34,35,27,33,129
8937,39,32,26,27,124
8938,30,34,35,32,131
8939,28,45,24,28,125
8940,33,24,41,32,130
8941,32,33,39,41,145
8942,29,32,38,37,136
8943,31,31,34,28,124
8944,32,30,26,28,116
8945,35,27,27,26,115
8946,22,27,34,36,119
8947,28,23,24,33,108
8948,26,32,33,25,116
8949,32,30,30,22,114
8950,38,30,31,37,136
8951,41,32,26,22,121
8952,32,37,30,33,132
8953,29,33,27,27,116
8954,34,38,29,34,135
8955,35,40,35,35,145
8956,21,28,27,41,117
8957,38,29,37,31,135
8958,34,22,30,36,122
8959,24,32,32,22,110
8960,33,30,35,24,122
8961,26,34,27,22,109
8962,30,32,24,33,119
8963,28,44,27,30,129
8964,32,33,34,23,122
8965,35,35,30,35,135
8966,39,29,27,36,131
8967,31,32,33,28,124
8968,29,39,31,26,125
8969,33,30,36,25,124
8970,38,35,28,24,125
8971,34,24,38,24,120
8972,34,26,38,36,134
8973,32,41,27,33,133
8974,32,25,27,24,108
8975,33,34,36,32,135
8976,23,30,32,32,117
8977,29,27,29,33,118
8978,28,35,24,33,120
8979,28,27,30,24,109
8980,32,27,34,39,132
8981,35,31,34,34,134
8982,26,40,30,31,127
8983,28,38,34,35,135
8984,36,41,26,26,129
8985,37,43,40,30,150
8986,36,45,27,30,138
8987,37,23,44,28,132
8988,36,38,27,22,123
8989,38,19,35,29,121
8990,26,40,32,25,123
8991,35,33,35,28,131
8992,34,37,29,36,136
8993,35,37,24,30,126
8994,23,43,31,28,125
8995,38,26,37,25,126
8996,25,32,31,37,125
8997,29,30,26,39,124
8998,30,28,42,27,127
8999,27,38,30,35,130
9000,39,34,29,27,129
9001,23,28,38,35,124
9002,32,42,46,37,157
9003,39,22,26,21,108
9004,22,37,32,25,116
9005,33,27,32,33,125
9006,39,33,30,24,126
9007,33,39,23,29,124
9008,39,33,26,33,131
9009,26,36,44,28,134
9010,26,26,25,39,116
9011,34,27,33,35,129
9012,25,24,27,42,118
9013,24,28,36,46,134
9014,32,31,24,26,113
9015,36,30,27,26,119
9016,27,30,29,39,125
9017,27,29,30,29,115
9018,33,27,37,27,124
9019,31,29,32,32,124
9020,33,26,35,28,122
9021,29,20,28,29,106
9022,37,30,32,25,124
9023,22,45,35,36,138
9024,27,44,32,39,142
9025,37,29,19,39,124
9026,30,30,26,28,114
9027,38,38,22,35,133
9028,31,33,26,36,126
9029,27,24,34,25,110
9030,28,26,31,32,117
9031,26,34,29,31,120
9032,37,27,33,27,124
9033,30,32,25,27,114
9034,28,33,31,31,123
9035,37,39,23,36,135
9036,34,29,33,34,130
9037,26,35,38,36,135
9038,33,25,34,35,127
9039,29,32,33,28,122
9040,43,32,31,35,141
9041,34,41,29,31,135
9042,30,32,36,25,123
9043,31,33,28,27,119
9044,37,27,31,27,122
9045,35,27,31,26,119
9046,42,17,39,33,131
9047,36,33,33,31,133
9048,33,27,31,31,122
9049,27,33,27,28,115
9050,34,24,33,30,121
9051,37,34,33,33,137
9052,28,37,42,30,137
9053,30,35,32,37,134
9054,37,31,39,32,139
9055,30,28,25,35,118
9056,33,31,25,35,124
9057,36,34,27,33,130
9058,30,27,31,39,127
9059,30,43,27,27,127
9060,29,34,29,34,126
9061,36,31,39,34,140
9062,28,35,32,29,124
9063,33,27,28,31,119
9064,23,33,41,38,135
9065,37,37,37,20,131
9066,28,24,35,26,113
9067,38,31,36,36,141
9068,29,30,24,32,115
9069,36,26,33,24,119
9070,28,31,24,45,128
9071,28,31,24,34,117
9072,28,35,29,32,124
9073,19,34,35,24,112
9074,29,25,29,33,116
9075,42,35,32,25,134
9076,33,39,28,29,129
9077,36,38,23,30,127
9078,27,31,41,27,126
9079,28,32,27,23,110
9080,26,34,25,38,123
9081,23,31,25,44,123
9082,32,32,33,34,131
9083,21,40,35,34,130
9084,40,32,27,41,140
9085,38,31,40,29,138
9086,38,30,34,27,129
9087,36,29,36,24,125
9088,31,37,28,32,128
9089,29,41,30,30,130
9090,33,36,30,24,123
9091,41,20,26,35,122
9092,31,28,36,36,131
9093,31,31,36,22,120
9094,25,35,20,25,105
9095,31,25,38,23,117
9096,29,29,34,36,128
9097,26,26,23,39,114
9098,22,36,36,33,127
9099,26,27,23,31,107
9100,24,27,37,34,122
9101,26,35,32,24,117
9102,32,24,42,33,131
9103,29,30,26,30,115
9104,31,40,27,28,126
9105,29,42,30,21,122
9106,25,33,24,29,111
9107,23,39,31,39,132
9108,40,37,38,31,146
9109,21,41,36,29,127
9110,37,24,33,36,130
9111,24,24,43,24,115
9112,27,35,26,33,121
9113,24,22,24,31,101
9114,26,30,29,36,121
9115,33,33,27,41,134
9116,25,35,29,35,124
9117,24,38,39,31,132
9118,31,23,34,30,118
9119,28,47,24,36,135
9120,38,27,37,34,136
9121,35,31,27,33,126
9122,38,15,35,36,124
9123,28,32,34,35,129
9124,34,29,28,38,129
9125,26,27,27,37,117
9126,26,28,23,40,117
9127,28,20,36,30,114
9128,28,31,31,39,129
9129,37,41,35,31,144
9130,35,18,32,27,112
9131,21,29,33,37,120
9132,30,22,44,29,125
9133,31,36,40,34,141
9134,24,34,30,27,115
9135,33,27,25,29,114
9136,33,29,33,31,126
9137,31,26,27,32,116
9138,33,28,30,35,126
9139,37,36,25,37,135
9140,32,22,40,33,127
9141,34,28,23,31,116
9142,30,39,30,35,134
9143,33,31,29,26,119
9144,23,35,38,26,122
9145,36,36,29,39,140
9146,26,26,38,33,123
9147,33,32,28,26,119
9148,31,28,42,38,139
9149,33,32,29,32,126
9150,24,37,29,28,118
9151,23,44,27,24,118
9152,35,25,34,32,126
9153,27,34,25,19,105
9154,25,30,28,24,107
9155,31,30,34,30,125
9156,39,30,26,23,118
9157,29,38,30,30,127
9158,39,39,29,31,138
9159,38,21,39,37,135
9160,25,27,37,30,119
9161,25,33,28,31,117
9162,35,33,30,35,133
9163,37,40,31,41,149
9164,40,23,40,19,122
9165,24,33,40,37,134
9166,31,37,38,23,129
9167,31,39,19,31,120
9168,23,28,27,25,103
9169,42,34,38,28,142
9170,31,28,27,41,127
9171,32,28,37,28,125
9172,29,31,35,37,132
9173,32,30,38,33,133
9174,45,27,25,26,123
9175,33,33,38,36,140
9176,39,28,31,24,122
9177,30,33,36,20,119
9178,33,32,37,27,129
9179,27,30,29,27,113
9180,25,28,31,31,115
9181,30,28,33,34,125
9182,30,30,36,33,129
9183,30,40,36,30,136
9184,27,22,36,31,116
9185,32,40,34,31,137
9186,26,27,31,27,111
9187,32,34,33,29,128
9188,28,35,32,27,122
9189,27,23,31,38,119
9190,26,35,35,29,125
9191,28,36,33,32,129
9192,32,40,28,28,128
9193,32,27,34,28,121
9194,28,32,32,27,119
9195,33,35,36,26,130
9196,34,16,37,38,125
9197,25,33,38,31,127
9198,28,25,33,43,129
9199,26,34,24,44,128
9200,29,26,29,27,111
9201,36,25,32,29,122
9202,35,33,34,28,130
9203,34,29,37,34,134
9204,34,28,34,31,127
9205,33,26,26,37,122
9206,27,45,26,31,129
9207,34,34,38,35,141
9208,34,32,18,34,118
9209,27,41,30,26,124
9210,27,24,35,35,121
9211,26,31,39,26,122
9212,37,33,27,39,136
9213,36,42,29,35,142
9214,33,37,34,46,150
9215,45,33,32,24,134
9216,32,27,33,39,131
9217,29,25,34,40,128
9218,16,26,44,27,113
9219,32,42,31,36,141
9220,30,39,43,28,140
9221,30,33,36,38,137
9222,31,26,44,32,133
9223,23,31,29,31,114
9224,36,29,26,31,122
9225,38,28,37,23,126
9226,35,29,42,44,150
9227,28,27,45,27,127
9228,27,29,36,20,112
9229,31,30,20,30,111
9230,27,46,23,29,125
9231,27,35,48,26,136
9232,29,26,26,23,104
9233,39,42,20,40,141
9234,36,38,33,27,134
9235,26,26,30,29,111
9236,32,27,26,36,121
9237,31,28,29,27,115
9238,22,28,29,31,110
9239,22,34,29,28,113
9240,29,32,25,28,114
9241,27,30,36,27,120
9242,30,35,32,40,137
9243,34,25,34,22,115
9244,33,26,28,37,124
9245,36,34,31,40,141
9246,29,23,30,30,112
9247,27,26,26,36,115
9248,38,21,29,37,125
9249,29,25,30,35,119
9250,31,32,31,32,126
9251,33,33,33,31,130
9252,43,25,26,31,125
9253,35,34,16,30,115
9254,29,44,35,30,138
9255,31,35,29,34,129
9256,30,28,32,32,122
9257,28,36,39,26,129
9258,33,31,31,34,129
9259,28,29,33,26,116
9260,26,21,23,22,92
9261,36,33,25,43,137
9262,29,27,36,31,123
9263,24,23,34,24,105
9264,36,30,29,33,128
9265,20,34,31,37,122
9266,40,29,29,25,123
9267,33,36,35,26,130
9268,23,27,28,30,108
9269,20,37,39,30,126
9270,28,36,27,25,116
9271,29,38,33,36,136
9272,18,22,38,41,119
9273,24,49,33,35,141
9274,34,23,22,37,116
9275,30,22,33,29,114
9276,44,33,26,37,140
9277,27,25,27,37,116
9278,35,26,36,33,130
9279,40,31,28,31,130
9280,39,27,37,27,130
9281,25,41,38,34,138
9282,23,38,29,36,126
9283,42,32,31,27,132
9284,29,21,24,25,99
9285,33,22,34,30,119
9286,37,30,22,28,117
9287,40,43,30,37,150
9288,29,35,26,31,121
9289,32,33,24,32,121
9290,20,30,33,34,117
9291,35,32,34,40,141
9292,40,30,33,30,133
9293,23,36,36,30,125
9294,33,28,29,28,118
9295,36,31,43,25,135
9296,35,30,30,45,140
9297,42,31,26,33,132
9298,27,33,27,33,120
9299,31,36,22,32,121
9300,26,36,27,37,126
9301,28,24,35,26,113
9302,37,40,32,36,145
9303,29,34,39,33,135
9304,36,33,29,25,123
9305,34,31,24,24,113
9306,27,34,26,29,116
9307,28,30,33,40,131
9308,37,29,36,26,128
9309,42,36,26,31,135
9310,31,31,34,32,128
9311,25,30,30,24,109
9312,28,26,35,49,138
9313,38,28,32,46,144
9314,25,41,35,25,126
9315,37,36,21,31,125
9316,39,40,37,30,146
9317,28,31,30,32,121
9318,24,34,25,31,114
9319,36,23,27,26,112
9320,38,35,38,34,145
9321,38,23,20,30,111
9322,25,38,33,29,125
9323,29,48,23,36,136
9324,28,45,35,30,138
9325,33,30,33,36,132
9326,26,31,27,26,110
9327,27,33,39,26,125
9328,36,27,29,25,117
9329,34,26,34,22,116
9330,23,18,33,38,112
9331,36,39,31,27,133
9332,39,26,25,30,120
9333,35,28,30,29,122
9334,40,21,34,28,123
9335,33,16,32,36,117
9336,34,36,36,27,133
9337,36,22,27,31,116
9338,29,40,29,31,129
9339,34,28,40,36,138
9340,32,30,26,24,112
9341,27,27,25,29,108
9342,22,29,39,26,116
9343,35,33,25,37,130
9344,30,28,30,25,113
9345,28,29,26,28,111
9346,36,32,33,29,130
9347,34,43,27,31,135
9348,37,28,33,29,127
9349,30,26,42,27,125
9350,20,29,36,40,125
9351,35,35,25,40,135
9352,37,25,33,31,126
9353,35,35,29,22,121
9354,26,22,26,36,110
9355,24,31,29,17,101
9356,34,33,28,30,125
9357,20,36,32,29,117
9358,38,23,39,25,125
9359,27,31,44,29,131
9360,29,24,31,31,115
9361,28,31,24,29,112
9362,34,18,29,36,117
9363,34,26,36,33,129
9364,24,27,40,27,118
9365,27,27,29,34,117
9366,34,34,34,26,128
9367,25,21,27,26,99
9368,44,25,28,28,125
9369,34,31,31,27,123
9370,28,36,28,23,115
9371,26,31,26,30,113
9372,32,37,33,26,128
9373,37,36,27,35,135
9374,28,24,39,38,129
9375,26,34,36,38,134
9376,29,29,38,29,125
9377,24,25,26,27,102
9378,41,30,22,36,129
9379,34,30,28,29,121
9380,26,38,37,28,129
9381,34,38,37,29,138
9382,37,44,23,32,136
9383,28,30,35,29,122
9384,27,38,27,19,111
9385,39,42,30,39,150
9386,24,36,25,34,119
9387,24,36,30,29,119
9388,30,36,30,25,121
9389,28,29,34,37,128
9390,30,28,33,32,123
9391,31,32,34,28,125
9392,35,29,30,34,128
9393,31,22,31,28,112
9394,32,29,22,27,110
9395,38,34,39,27,138
9396,31,37,31,32,131
9397,32,39,40,22,133
9398,25,25,27,33,110
9399,30,27,29,24,110
9400,37,31,26,39,133
9401,22,31,33,27,113
9402,35,35,28,34,132
9403,26,29,33,27,115
9404,27,30,28,28,113
9405,33,35,34,28,130
9406,27,33,33,30,123
9407,33,27,26,37,123
9408,32,34,36,34,136
9409,30,28,44,29,131
9410,42,30,46,25,143
9411,23,38,32,38,131
9412,29,28,34,28,119
9413,29,32,31,40,132
9414,28,33,38,31,130
9415,26,29,36,33,124
9416,29,28,40,24,121
9417,36,41,40,22,139
9418,36,36,37,20,129
9419,35,26,36,32,129
9420,34,25,25,43,127
9421,34,36,31,25,126
9422,27,27,29,36,119
9423,24,42,30,28,124
9424,34,27,32,31,124
9425,32,30,26,39,127
9426,35,31,27,23,116
9427,18,30,46,30,124
9428,29,28,35,27,119
9429,36,28,27,38,129
9430,27,23,37,23,110
9431,33,34,38,37,142
9432,35,30,34,25,124
9433,29,41,38,27,135
9434,28,32,37,40,137
9435,36,24,28,24,112
9436,24,34,46,21,125
9437,23,33,27,30,113
9438,39,23,33,25,120
9439,29,31,25,44,129
9440,32,31,24,31,118
9441,28,33,25,26,112
9442,27,39,31,25,122
9443,28,26,24,32,110
9444,35,39,23,20,117
9445,31,32,28,34,125
9446,31,32,25,29,117
9447,29,40,26,44,139
9448,32,35,24,13,104
9449,29,29,32,34,124
9450,34,30,35,26,125
9451,33,37,28,31,129
9452,31,25,29,30,115
9453,32,43,32,32,139
9454,32,29,45,31,137
9455,34,26,23,27,110
9456,43,29,33,34,139
9457,23,37,21,27,108
9458,30,24,31,47,132
9459,30,32,44,33,139
9460,26,33,34,28,121
9461,31,29,28,31,119
9462,20,34,33,22,109
9463,28,34,26,24,112
9464,19,31,34,30,114
9465,22,21,46,39,128
9466,36,29,28,35,128
9467,27,41,27,23,118
9468,30,34,29,21,114
9469,36,29,36,27,128
9470,32,26,22,38,118
9471,23,29,35,34,121
9472,27,32,27,41,127
9473,30,28,22,37,117
9474,36,28,31,28,123
9475,25,29,49,31,134
9476,25,36,33,36,130
9477,30,27,29,31,117
9478,24,35,22,41,122
9479,29,33,35,34,131
9480,29,30,32,34,125
9481,31,26,35,27,119
9482,28,36,34,34,132
9483,32,34,36,37,139
9484,25,28,36,39,128
9485,29,33,31,32,125
9486,36,32,31,40,139
9487,31,25,23,25,104
9488,24,41,22,27,114
9489,25,30,32,35,122
9490,25,25,38,31,119
9491,31,35,31,28,125
9492,36,38,31,30,135
9493,30,30,25,31,116
9494,23,36,31,32,122
9495,26,29,38,31,124
9496,41,23,38,41,143
9497,33,34,31,28,126
9498,23,33,35,30,121
9499,26,26,32,35,119
9500,35,31,35,16,117
9501,26,31,30,26,113
9502,25,37,18,43,123
9503,31,32,42,34,139
9504,26,37,36,42,141
9505,37,24,42,24,127
9506,35,35,25,38,133
9507,28,22,29,26,105
9508,34,37,44,25,140
9509,36,31,28,31,126
9510,35,31,42,36,144
9511,34,36,20,33,123
9512,28,41,27,30,126
9513,39,22,39,32,132
9514,38,31,33,33,135
9515,38,36,31,25,130
9516,30,25,38,30,123
9517,20,33,37,32,122
9518,33,38,34,27,132
9519,29,31,44,35,139
9520,34,30,31,25,120
9521,42,39,15,34,130
9522,31,20,31,17,99
9523,43,22,34,35,134
9524,29,45,27,31,132
9525,39,31,37,24,131
9526,29,28,36,40,133
9527,26,30,35,22,113
9528,35,38,32,23,128
9529,34,22,27,35,118
9530,39,34,38,26,137
9531,34,29,29,32,124
9532,42,29,38,28,137
9533,37,25,31,44,137
9534,25,30,31,36,122
9535,30,44,26,33,133
9536,26,37,23,45,131
9537,38,34,22,31,125
9538,30,36,37,37,140
9539,40,30,39,25,134
9540,41,32,42,34,149
9541,28,26,36,40,130
9542,46,29,30,31,136
9543,30,37,47,23,137
9544,33,36,36,26,131
9545,30,29,36,27,122
9546,41,40,30,42,153
9547,31,27,27,21,106
9548,27,38,23,24,112
9549,32,25,34,28,119
9550,31,22,39,22,114
9551,28,40,25,36,129
9552,35,33,33,26,127
9553,41,34,37,27,139
9554,38,33,34,32,137
9555,26,34,37,23,120
9556,38,36,33,34,141
9557,29,31,25,32,117
9558,28,30,46,32,136
9559,30,32,34,37,133
9560,28,32,36,25,121
9561,37,38,30,33,138
9562,26,18,32,25,101
9563,30,31,32,30,123
9564,32,35,30,35,132
9565,23,31,40,35,129
9566,31,29,41,28,129
9567,30,36,28,36,130
9568,26,30,26,32,114
9569,27,33,25,32,117
9570,33,26,35,43,137
9571,30,33,51,44,158
9572,31,43,31,27,132
9573,28,31,36,27,122
9574,28,30,31,40,129
9575,39,33,41,34,147
9576,29,25,25,27,106
9577,36,28,36,33,133
9578,41,36,30,32,139
9579,35,35,28,34,132
9580,33,28,33,25,119
9581,29,38,37,34,138
9582,30,25,36,29,120
9583,37,20,36,27,120
9584,29,32,24,35,120
9585,37,28,32,26,123
9586,49,32,24,31,136
9587,32,27,27,25,111
9588,31,30,29,29,119
9589,35,31,26,27,119
9590,39,30,28,30,127
9591,34,32,25,35,126
9592,21,38,32,20,111
9593,29,29,29,30,117
9594,27,28,23,25,103
9595,36,36,48,30,150
9596,28,37,32,35,132
9597,38,34,27,34,133
9598,31,26,28,28,113
9599,30,27,34,35,126
9600,30,26,39,27,122
9601,33,32,24,30,119
9602,37,33,31,26,127
9603,28,37,36,34,135
9604,21,28,34,38,121
9605,24,21,29,28,102
9606,31,33,29,29,122
9607,38,35,29,35,137
9608,32,30,23,25,110
9609,30,36,31,24,121
9610,25,36,41,27,129
9611,31,29,45,26,131
9612,30,35,22,28,115
9613,27,43,30,27,127
9614,31,36,25,23,115
9615,33,28,39,26,126
9616,28,28,37,41,134
9617,37,30,37,28,132
9618,32,29,37,28,126
9619,24,17,34,36,111
9620,23,32,25,30,110
9621,36,31,38,30,135
9622,18,29,33,27,107
9623,31,30,36,28,125
9624,36,33,23,37,129
9625,31,21,26,30,108
9626,27,26,42,27,122
9627,32,38,33,27,130
9628,41,29,33,30,133
9629,25,31,35,26,117
9630,21,38,25,25,109
9631,27,25,31,38,121
9632,32,26,25,30,113
9633,36,29,33,31,129
9634,36,31,28,33,128
9635,25,29,32,38,124
9636,34,33,24,28,119
9637,25,25,45,42,137
9638,32,33,26,34,125
9639,44,24,27,29,124
9640,26,23,31,31,111
9641,45,33,25,38,141
9642,27,25,36,35,123
9643,29,39,31,39,138
9644,38,30,30,30,128
9645,41,39,22,27,129
9646,26,34,28,24,112
9647,30,26,33,28,117
9648,29,27,37,37,130
9649,38,30,27,29,124
9650,26,22,36,35,119
9651,29,26,30,27,112
9652,37,32,33,37,139
9653,34,31,30,26,121
9654,20,41,26,37,124
9655,34,42,31,26,133
9656,25,38,30,37,130
9657,31,35,35,37,138
9658,29,28,32,40,129
9659,37,31,26,33,127
9660,30,31,39,29,129
9661,28,28,25,24,105
9662,28,33,16,20,97
9663,28,29,32,29,118
9664,35,32,32,27,126
9665,27,30,32,33,122
9666,52,36,27,25,140
9667,32,31,24,33,120
9668,32,29,29,32,122
9669,30,28,35,34,127
9670,34,36,17,31,118
9671,46,33,28,33,140
9672,21,36,21,27,105
9673,42,30,32,36,140
9674,33,27,36,38,134
9675,34,26,40,28,128
9676,29,33,28,31,121
9677,38,34,26,34,132
9678,33,30,30,47,140
9679,26,36,24,26,112
9680,30,21,31,32,114
9681,25,32,39,38,134
9682,35,25,23,36,119
9683,28,35,31,38,132
9684,32,36,32,32,132
9685,34,24,23,33,114
9686,35,36,29,30,130
9687,24,35,33,38,130
9688,31,23,28,37,119
9689,29,39,28,40,136
9690,32,32,38,33,135
9691,25,34,30,41,130
9692,35,27,38,28,128
9693,28,24,20,33,105
9694,31,25,28,30,114
9695,35,28,28,31,122
9696,35,17,27,25,104
9697,42,38,33,31,144
9698,28,34,32,31,125
9699,30,27,36,32,125
9700,20,33,36,35,124
9701,32,24,34,28,118
9702,23,33,23,26,105
9703,31,21,36,22,110
9704,34,33,36,31,134
9705,25,34,31,28,118
9706,22,36,40,30,128
9707,34,29,24,21,108
9708,26,31,29,25,111
9709,30,30,30,32,122
9710,36,28,38,24,126
9711,36,32,37,39,144
9712,26,22,36,36,120
9713,41,28,39,30,138
9714,25,26,31,38,120
9715,30,36,29,35,130
9716,26,31,34,25,116
9717,32,42,28,32,134
9718,27,30,27,36,120
9719,33,30,34,35,132
9720,27,31,35,32,125
9721,31,28,46,30,135
9722,30,36,34,26,126
9723,32,33,32,35,132
9724,21,29,29,32,111
9725,21,31,37,30,119
9726,29,29,26,43,127
9727,26,32,26,31,115
9728,32,25,30,36,123
9729,34,21,35,31,121
9730,29,35,36,37,137
9731,28,19,23,34,104
9732,25,30,22,35,112
9733,32,36,26,26,120
9734,31,30,29,23,113
9735,29,34,26,27,116
9736,32,39,27,31,129
9737,36,32,27,35,130
9738,39,34,28,27,128
9739,32,26,35,36,129
9740,26,41,40,31,138
9741,39,44,38,33,154
9742,38,31,28,33,130
9743,30,31,35,21,117
9744,32,37,20,37,126
9745,32,36,39,34,141
9746,29,43,20,33,125
9747,25,37,30,27,119
9748,37,25,37,28,127
9749,32,32,41,35,140
9750,40,33,28,38,139
9751,27,34,17,29,107
9752,32,21,33,35,121
9753,26,31,21,23,101
9754,35,32,41,35,143
9755,32,35,26,29,122
9756,31,30,29,20,110
9757,42,37,32,32,143
9758,47,32,24,31,134
9759,21,24,33,30,108
9760,37,35,36,40,148
9761,28,32,29,30,119
9762,37,31,31,30,129
9763,30,33,27,41,131
9764,33,22,32,32,119
9765,30,24,26,44,124
9766,33,28,26,30,117
9767,24,42,38,21,125
9768,30,33,27,25,115
9769,33,35,26,37,131
9770,40,26,32,31,129
9771,29,30,30,26,115
9772,41,24,31,23,119
9773,30,30,26,22,108
9774,39,26,36,29,130
9775,28,32,30,35,125
9776,26,30,34,36,126
9777,22,35,26,34,117
9778,34,23,26,40,123
9779,20,27,35,42,124
9780,39,25,39,29,132
9781,24,34,34,44,136
9782,31,27,29,38,125
9783,32,32,30,33,127
9784,35,30,27,34,126
9785,34,28,31,30,123
9786,34,41,39,29,143
9787,32,30,30,34,126
9788,30,24,40,38,132
9789,32,25,28,35,120
9790,22,38,25,42,127
9791,41,25,31,31,128
9792,26,31,31,40,128
9793,20,37,27,27,111
9794,34,28,28,35,125
9795,26,29,22,28,105
9796,35,32,36,30,133
9797,31,20,30,34,115
9798,39,25,34,32,130
9799,35,27,24,33,119
9800,27,26,34,32,119
9801,35,25,30,39,129
9802,28,28,31,31,118
9803,35,40,27,32,134
9804,36,34,33,30,133
9805,34,36,36,33,139
9806,35,22,39,29,125
9807,37,29,33,33,132
9808,40,32,28,29,129
9809,27,23,31,31,112
9810,30,25,26,36,117
9811,24,30,38,35,127
9812,30,48,26,25,129
9813,34,34,28,33,129
9814,36,39,23,33,131
9815,28,31,30,30,119
9816,28,40,31,22,121
9817,30,28,33,27,118
9818,25,41,34,30,130
9819,40,26,41,28,135
9820,40,34,19,30,123
9821,36,29,25,29,119
9822,30,35,30,44,139
9823,35,31,29,32,127
9824,39,29,27,30,125
9825,34,32,40,30,136
9826,26,24,28,31,109
9827,35,30,30,28,123
9828,37,25,30,41,133
9829,29,30,37,30,126
9830,37,35,27,27,126
9831,37,32,30,29,128
9832,30,35,29,24,118
9833,41,40,22,33,136
9834,28,25,31,34,118
9835,26,25,29,33,113
9836,30,29,36,39,134
9837,35,27,25,20,107
9838,33,36,27,30,126
9839,28,31,30,44,133
9840,24,32,29,32,117
9841,29,26,39,42,136
9842,25,23,28,32,108
9843,26,34,28,29,117
9844,37,35,38,25,135
9845,28,30,30,29,117
9846,31,27,15,32,105
9847,24,31,40,36,131
9848,34,31,45,24,134
9849,26,23,41,30,120
9850,29,32,31,42,134
9851,27,29,33,25,114
9852,29,33,34,35,131
9853,21,31,26,38,116
9854,27,32,30,29,118
9855,32,27,28,31,118
9856,28,35,29,33,125
9857,31,33,30,21,115
9858,32,29,25,41,127
9859,31,28,36,31,126
9860,28,28,34,27,117
9861,34,29,31,28,122
9862,29,28,31,29,117
9863,31,30,30,31,122
9864,24,32,30,27,113
9865,33,36,38,35,142
9866,36,23,38,30,127
9867,31,31,29,39,130
9868,31,32,23,25,111
9869,26,32,29,26,113
9870,34,29,33,31,127
9871,31,35,32,39,137
9872,33,27,34,29,123
9873,33,42,26,25,126
9874,31,17,36,33,117
9875,28,31,27,27,113
9876,32,26,37,35,130
9877,30,31,19,24,104
9878,31,26,26,33,116
9879,27,32,40,28,127
9880,38,45,25,20,128
9881,34,31,39,35,139
9882,32,27,35,39,133
9883,20,44,31,26,121
9884,36,26,23,33,118
9885,34,30,27,50,141
9886,33,24,32,33,122
9887,35,24,36,36,131
9888,36,27,29,27,119
9889,29,24,37,35,125
9890,33,25,32,36,126
9891,25,22,31,32,110
9892,42,29,28,30,129
9893,22,35,24,35,116
9894,40,27,39,33,139
9895,42,39,34,29,144
9896,25,37,29,34,125
9897,36,30,32,26,124
9898,29,24,30,33,116
9899,41,23,41,41,146
9900,31,30,38,23,122
9901,33,24,30,25,112
9902,34,28,30,31,123
9903,26,26,31,37,120
9904,37,42,30,23,132
9905,35,36,26,34,131
9906,33,30,30,31,124
9907,30,26,36,32,124
9908,28,24,32,22,106
9909,25,23,32,22,102
9910,25,27,32,29,113
9911,33,39,37,34,143
9912,29,41,40,25,135
9913,29,29,29,28,115
9914,26,36,39,34,135
9915,29,32,31,27,119
9916,34,34,24,28,120
9917,37,19,31,24,111
9918,25,35,46,27,133
9919,32,39,36,29,136
9920,40,28,33,37,138
9921,28,31,33,27,119
9922,38,28,27,30,123
9923,31,29,31,33,124
9924,33,28,34,26,121
9925,30,30,39,25,124
9926,23,30,35,21,109
9927,27,32,29,33,121
9928,31,24,40,35,130
9929,31,28,22,31,112
9930,37,29,30,35,131
9931,34,38,25,28,125
9932,25,37,31,32,125
9933,26,28,32,39,125
9934,36,29,35,33,133
9935,36,26,27,33,122
9936,39,30,39,28,136
9937,31,26,32,18,107
9938,26,33,29,23,111
9939,39,28,28,40,135
9940,33,28,34,18,113
9941,34,29,31,32,126
9942,33,23,30,34,120
9943,21,27,24,28,100
9944,33,27,23,33,116
9945,26,37,31,35,129
9946,42,35,33,31,141
9947,28,27,26,33,114
9948,37,33,29,24,123
9949,33,30,26,39,128
9950,32,27,41,31,131
9951,27,30,25,34,116
9952,42,33,28,32,135
9953,19,32,39,30,120
9954,27,32,37,28,124
9955,24,32,30,32,118
9956,30,29,33,30,122
9957,27,32,43,23,125
9958,31,34,37,26,128
9959,34,27,22,37,120
9960,31,44,30,22,127
9961,25,33,26,43,127
9962,33,32,25,38,128
9963,24,24,32,35,115
9964,32,36,33,29,130
9965,29,31,34,29,123
9966,26,35,40,25,126
9967,35,28,29,26,118
9968,30,29,36,24,119
9969,23,29,33,36,121
9970,32,28,29,32,121
9971,27,29,35,39,130
9972,32,34,20,32,118
9973,37,25,34,28,124
9974,29,27,28,17,101
9975,32,35,28,35,130
9976,35,32,27,27,121
9977,33,23,29,33,118
9978,28,38,26,37,129
9979,27,29,22,38,116
9980,37,24,28,32,121
9981,36,31,36,25,128
9982,38,35,21,34,128
9983,31,37,32,29,129
9984,21,38,31,37,127
9985,33,29,41,30,133
9986,26,42,36,32,136
9987,32,33,42,29,136
9988,31,39,33,35,138
9989,30,20,28,30,108
9990,36,28,31,39,134
9991,26,35,32,37,130
9992,37,29,30,30,126
9993,37,36,31,34,138
9994,30,27,32,33,122
9995,27,20,32,33,112
9996,24,26,32,30,112
9997,33,24,28,31,116
9998,34,33,29,34,130
9999,35,24,27,33,119
