,A,T,C,G,sum
0,22,30,24,18,94
1,25,23,17,24,89
2,15,31,21,23,90
3,23,17,22,32,94
4,25,29,25,24,103
5,30,27,27,28,112
6,28,22,20,22,92
7,19,23,27,26,95
8,20,23,19,22,84
9,24,23,23,28,98
10,24,21,23,23,91
11,27,25,20,14,86
12,28,31,13,27,99
13,25,36,34,31,126
14,22,28,18,20,88
15,18,23,22,21,84
16,23,27,21,24,95
17,18,30,27,19,94
18,29,27,26,18,100
19,19,34,26,24,103
20,26,31,19,23,99
21,22,18,19,28,87
22,25,29,36,31,121
23,24,32,28,24,108
24,26,29,21,22,98
25,30,21,28,23,102
26,22,33,27,34,116
27,23,32,23,28,106
28,21,31,26,18,96
29,25,29,30,22,106
30,26,27,27,28,108
31,27,26,26,20,99
32,22,19,18,14,73
33,22,33,30,20,105
34,20,26,35,25,106
35,20,27,16,24,87
36,32,31,21,26,110
37,23,23,19,23,88
38,30,34,33,23,120
39,22,33,26,27,108
40,21,26,24,29,100
41,26,33,23,26,108
42,29,28,24,23,104
43,20,29,23,20,92
44,33,32,28,18,111
45,29,26,25,25,105
46,34,29,19,26,108
47,29,23,15,20,87
48,32,27,29,28,116
49,31,25,29,23,108
50,25,23,19,19,86
51,21,24,23,19,87
52,19,27,32,28,106
53,31,22,18,29,100
54,19,31,20,25,95
55,39,24,29,28,120
56,33,25,27,23,108
57,22,33,20,25,100
58,32,16,26,22,96
59,18,27,21,27,93
60,25,24,23,20,92
61,25,30,24,21,100
62,28,24,28,28,108
63,17,26,26,28,97
64,24,26,20,18,88
65,19,25,25,22,91
66,16,23,19,27,85
67,27,22,21,27,97
68,25,33,24,19,101
69,16,37,31,21,105
70,25,28,31,23,107
71,24,28,21,23,96
72,20,27,25,26,98
73,27,29,22,24,102
74,18,25,14,29,86
75,30,27,16,27,100
76,18,29,20,24,91
77,25,34,28,26,113
78,20,24,27,18,89
79,22,31,28,24,105
80,22,34,26,26,108
81,33,21,32,20,106
82,26,29,18,22,95
83,15,20,21,18,74
84,26,29,19,34,108
85,30,36,19,21,106
86,24,33,26,25,108
87,24,19,27,28,98
88,28,23,26,19,96
89,17,28,27,25,97
90,16,27,26,23,92
91,18,26,34,19,97
92,21,24,27,30,102
93,25,27,23,26,101
94,25,25,25,26,101
95,26,32,21,22,101
96,21,27,22,21,91
97,25,22,20,26,93
98,30,26,17,18,91
99,18,29,22,18,87
100,22,31,29,37,119
101,23,25,22,27,97
102,23,18,23,25,89
103,20,20,27,35,102
104,19,32,22,28,101
105,25,28,38,21,112
106,19,29,18,23,89
107,27,29,31,28,115
108,29,20,19,31,99
109,14,27,17,20,78
110,18,22,24,23,87
111,17,27,19,31,94
112,18,34,23,21,96
113,21,24,18,23,86
114,14,32,26,25,97
115,20,26,28,26,100
116,22,27,21,23,93
117,22,25,32,28,107
118,15,25,22,20,82
119,25,28,24,27,104
120,31,36,24,27,118
121,16,30,25,20,91
122,38,24,24,17,103
123,22,29,24,25,100
124,22,32,28,28,110
125,32,26,19,25,102
126,18,33,33,21,105
127,24,18,22,25,89
128,24,28,26,27,105
129,28,20,30,26,104
130,20,28,17,25,90
131,26,28,25,26,105
132,20,35,27,29,111
133,18,22,20,24,84
134,23,27,21,17,88
135,32,23,32,23,110
136,29,24,16,35,104
137,25,31,22,27,105
138,22,19,20,19,80
139,25,28,16,26,95
140,28,28,28,22,106
141,22,18,25,22,87
142,21,26,19,12,78
143,25,29,23,28,105
144,27,26,22,23,98
145,19,29,30,29,107
146,18,29,23,33,103
147,17,39,29,27,112
148,18,35,21,31,105
149,26,37,30,26,119
150,15,32,21,16,84
151,26,25,18,18,87
152,35,35,25,25,120
153,21,30,24,24,99
154,29,32,22,21,104
155,24,30,26,25,105
156,26,30,29,27,112
157,21,23,23,34,101
158,20,23,32,31,106
159,20,22,16,25,83
160,29,26,23,30,108
161,23,31,29,22,105
162,22,31,23,30,106
163,32,29,24,20,105
164,26,31,21,29,107
165,22,18,30,24,94
166,25,34,27,39,125
167,30,26,20,23,99
168,16,31,24,16,87
169,29,24,27,23,103
170,24,27,32,31,114
171,30,16,22,30,98
172,23,25,20,30,98
173,27,36,20,40,123
174,22,30,19,27,98
175,25,28,27,21,101
176,17,24,20,18,79
177,33,28,23,19,103
178,25,30,24,28,107
179,30,26,30,23,109
180,17,32,24,22,95
181,28,30,19,20,97
182,22,32,18,22,94
183,19,32,22,21,94
184,20,16,29,29,94
185,21,27,16,17,81
186,17,29,21,26,93
187,18,30,25,22,95
188,25,33,24,37,119
189,25,18,17,24,84
190,27,22,19,25,93
191,25,27,27,22,101
192,22,26,16,33,97
193,32,25,34,18,109
194,18,20,24,26,88
195,33,24,19,30,106
196,26,27,29,24,106
197,26,25,22,26,99
198,19,27,22,16,84
199,32,22,27,28,109
200,33,21,28,25,107
201,31,40,39,26,136
202,35,16,28,27,106
203,22,20,23,26,91
204,22,19,35,26,102
205,33,18,19,31,101
206,31,28,26,30,115
207,28,30,29,33,120
208,24,29,22,25,100
209,24,24,20,20,88
210,27,28,23,29,107
211,27,35,26,24,112
212,16,19,29,21,85
213,26,30,26,23,105
214,27,25,15,28,95
215,24,24,21,22,91
216,28,29,33,34,124
217,16,21,29,28,94
218,37,29,27,21,114
219,24,32,33,29,118
220,14,15,13,22,64
221,28,20,18,23,89
222,19,20,23,23,85
223,23,25,22,25,95
224,34,34,29,15,112
225,28,29,15,20,92
226,21,23,28,13,85
227,24,33,27,32,116
228,20,20,18,22,80
229,24,32,29,19,104
230,25,33,26,22,106
231,26,32,29,33,120
232,25,19,19,27,90
233,31,24,25,29,109
234,17,26,20,22,85
235,25,35,28,28,116
236,20,26,23,30,99
237,25,32,19,20,96
238,22,31,18,27,98
239,14,21,31,26,92
240,25,22,23,24,94
241,28,27,23,14,92
242,32,28,22,25,107
243,27,27,24,14,92
244,22,27,25,17,91
245,31,24,25,20,100
246,20,26,26,19,91
247,21,27,25,26,99
248,24,25,21,23,93
249,20,20,24,29,93
250,14,39,28,24,105
251,21,26,19,25,91
252,28,30,23,23,104
253,28,32,23,19,102
254,27,25,26,19,97
255,24,34,22,26,106
256,16,23,29,23,91
257,31,30,18,26,105
258,15,28,32,20,95
259,20,22,13,26,81
260,31,28,29,31,119
261,21,26,24,26,97
262,23,29,18,25,95
263,29,27,21,31,108
264,26,30,22,26,104
265,15,24,29,28,96
266,24,23,28,32,107
267,20,29,17,15,81
268,22,35,20,28,105
269,23,29,29,19,100
270,17,22,16,29,84
271,29,31,26,24,110
272,22,31,23,28,104
273,28,28,24,25,105
274,20,32,23,26,101
275,22,28,22,26,98
276,23,28,23,28,102
277,21,33,15,21,90
278,21,28,23,23,95
279,31,23,17,23,94
280,27,28,19,19,93
281,32,24,37,23,116
282,22,20,25,18,85
283,33,29,28,25,115
284,25,20,27,21,93
285,19,30,14,34,97
286,30,29,23,22,104
287,20,27,19,17,83
288,20,29,19,27,95
289,23,31,25,19,98
290,28,28,25,30,111
291,21,31,30,28,110
292,38,35,17,30,120
293,29,29,25,25,108
294,21,20,29,24,94
295,25,31,38,28,122
296,21,25,20,30,96
297,29,33,28,28,118
298,27,30,21,20,98
299,28,33,24,30,115
300,21,25,26,28,100
301,29,38,20,28,115
302,18,28,30,21,97
303,24,33,24,30,111
304,29,27,25,21,102
305,19,30,19,26,94
306,16,26,27,17,86
307,19,25,26,23,93
308,39,15,20,22,96
309,29,33,15,24,101
310,25,30,26,29,110
311,15,20,23,20,78
312,27,23,22,22,94
313,29,23,15,30,97
314,22,37,20,20,99
315,19,34,34,29,116
316,25,24,17,22,88
317,25,33,24,26,108
318,20,24,20,29,93
319,32,30,26,21,109
320,24,21,26,24,95
321,21,23,30,32,106
322,24,34,22,17,97
323,27,35,23,29,114
324,29,23,20,23,95
325,22,33,23,15,93
326,27,31,25,27,110
327,27,34,30,22,113
328,28,29,23,26,106
329,25,31,21,28,105
330,20,32,17,20,89
331,27,23,20,17,87
332,26,25,33,27,111
333,24,26,21,17,88
334,17,29,15,26,87
335,26,19,16,22,83
336,30,29,25,22,106
337,19,24,30,31,104
338,17,38,24,23,102
339,28,34,19,24,105
340,23,26,30,25,104
341,21,23,26,27,97
342,26,28,24,23,101
343,22,21,13,18,74
344,22,29,28,22,101
345,19,27,18,24,88
346,22,27,23,27,99
347,33,23,16,34,106
348,27,31,24,28,110
349,29,27,23,27,106
350,25,32,29,24,110
351,30,25,26,23,104
352,25,27,24,22,98
353,29,31,25,20,105
354,30,20,19,24,93
355,25,22,23,22,92
356,23,35,22,23,103
357,28,30,13,31,102
358,25,26,32,34,117
359,22,32,22,25,101
360,28,29,26,31,114
361,23,22,21,22,88
362,27,29,21,26,103
363,25,15,26,22,88
364,32,27,25,42,126
365,25,23,20,28,96
366,25,23,23,33,104
367,18,27,25,26,96
368,26,29,22,34,111
369,31,28,21,28,108
370,32,22,18,22,94
371,26,28,20,20,94
372,28,30,23,22,103
373,21,33,26,36,116
374,30,28,23,25,106
375,31,27,16,24,98
376,25,25,17,28,95
377,19,33,20,26,98
378,16,30,21,21,88
379,25,34,32,33,124
380,34,31,15,27,107
381,22,26,23,27,98
382,22,37,32,29,120
383,17,28,20,23,88
384,27,29,20,23,99
385,26,26,28,24,104
386,18,28,17,26,89
387,27,24,22,32,105
388,35,33,28,21,117
389,28,18,28,20,94
390,25,21,27,31,104
391,32,21,22,18,93
392,21,28,22,28,99
393,19,24,16,32,91
394,19,17,34,18,88
395,26,25,21,22,94
396,17,40,18,20,95
397,21,26,19,21,87
398,27,24,21,25,97
399,19,19,25,24,87
400,21,37,29,30,117
401,30,28,19,23,100
402,22,27,30,22,101
403,18,31,31,28,108
404,27,41,27,24,119
405,27,34,19,22,102
406,24,30,26,29,109
407,26,26,25,28,105
408,22,31,27,23,103
409,23,24,28,25,100
410,24,26,27,24,101
411,17,20,39,30,106
412,35,23,29,29,116
413,28,30,21,23,102
414,21,22,18,14,75
415,27,23,20,20,90
416,15,29,18,28,90
417,24,33,18,28,103
418,27,18,37,22,104
419,29,25,27,25,106
420,20,33,15,16,84
421,28,22,12,29,91
422,24,30,27,19,100
423,21,29,20,24,94
424,22,29,19,33,103
425,19,31,32,25,107
426,26,29,25,26,106
427,19,25,32,23,99
428,20,31,25,19,95
429,21,38,21,22,102
430,22,28,18,25,93
431,28,27,16,15,86
432,25,26,18,18,87
433,28,20,20,20,88
434,23,35,33,30,121
435,22,26,20,30,98
436,20,29,32,23,104
437,23,21,19,19,82
438,13,24,15,20,72
439,16,25,28,18,87
440,19,17,22,22,80
441,22,24,23,22,91
442,23,28,18,30,99
443,23,25,24,17,89
444,27,25,20,37,109
445,23,23,32,27,105
446,22,24,16,26,88
447,25,41,24,25,115
448,26,24,22,34,106
449,19,26,21,27,93
450,23,35,24,29,111
451,23,30,22,27,102
452,19,25,20,27,91
453,28,29,26,24,107
454,26,20,32,28,106
455,29,22,23,38,112
456,33,27,26,30,116
457,37,30,24,22,113
458,17,23,26,18,84
459,25,32,27,32,116
460,17,23,19,24,83
461,22,25,27,20,94
462,23,26,21,26,96
463,20,25,16,18,79
464,24,28,22,23,97
465,20,37,20,29,106
466,19,26,32,26,103
467,25,25,28,22,100
468,23,32,26,18,99
469,30,28,29,24,111
470,29,27,29,29,114
471,24,28,22,19,93
472,21,32,17,22,92
473,31,26,15,22,94
474,26,35,27,23,111
475,24,24,22,29,99
476,26,33,21,22,102
477,20,28,27,22,97
478,22,35,19,22,98
479,26,26,19,32,103
480,14,23,20,28,85
481,31,32,32,40,135
482,24,28,24,19,95
483,21,32,24,18,95
484,21,34,16,26,97
485,20,23,21,21,85
486,26,23,27,26,102
487,21,34,18,31,104
488,20,31,27,24,102
489,26,28,18,25,97
490,28,26,22,33,109
491,19,27,22,20,88
492,25,19,27,21,92
493,23,36,26,16,101
494,24,23,20,21,88
495,24,29,31,36,120
496,23,35,22,19,99
497,22,26,21,23,92
498,28,27,27,20,102
499,22,29,20,23,94
500,33,25,23,26,107
501,25,30,27,17,99
502,23,23,32,31,109
503,27,25,21,27,100
504,24,29,28,15,96
505,20,32,27,26,105
506,27,27,23,23,100
507,28,28,27,24,107
508,27,27,23,21,98
509,21,24,33,27,105
510,17,34,18,34,103
511,26,21,18,25,90
512,28,30,26,21,105
513,21,28,17,20,86
514,32,27,18,29,106
515,26,20,24,25,95
516,24,29,29,26,108
517,28,25,16,18,87
518,30,27,23,28,108
519,25,28,25,28,106
520,25,23,27,26,101
521,28,21,32,26,107
522,28,30,25,30,113
523,24,21,22,28,95
524,29,31,20,21,101
525,25,25,17,27,94
526,25,24,32,25,106
527,28,28,27,27,110
528,27,23,28,24,102
529,22,31,26,28,107
530,28,27,18,25,98
531,24,26,20,22,92
532,24,26,25,29,104
533,28,32,21,23,104
534,17,22,26,22,87
535,21,20,33,28,102
536,23,29,23,27,102
537,17,24,24,26,91
538,19,25,27,23,94
539,31,30,28,24,113
540,19,26,22,23,90
541,21,24,21,26,92
542,35,22,21,16,94
543,25,23,21,22,91
544,18,25,20,22,85
545,25,25,26,20,96
546,24,31,21,23,99
547,25,33,25,21,104
548,28,23,23,17,91
549,27,26,18,23,94
550,29,26,29,38,122
551,24,34,16,22,96
552,29,25,20,22,96
553,28,29,23,29,109
554,35,28,30,20,113
555,31,24,23,19,97
556,30,23,20,21,94
557,30,30,16,30,106
558,25,24,31,22,102
559,30,34,25,31,120
560,26,29,27,24,106
561,26,19,22,24,91
562,20,30,24,34,108
563,21,25,23,30,99
564,26,28,21,21,96
565,29,27,31,22,109
566,31,29,21,25,106
567,19,37,29,28,113
568,28,31,20,22,101
569,19,26,27,19,91
570,25,26,26,24,101
571,23,24,27,34,108
572,25,32,28,26,111
573,33,31,20,18,102
574,25,20,22,17,84
575,22,29,21,23,95
576,37,26,18,16,97
577,38,32,27,27,124
578,27,31,31,33,122
579,26,35,17,17,95
580,26,29,22,26,103
581,31,25,19,23,98
582,28,31,19,27,105
583,29,28,18,35,110
584,28,25,20,23,96
585,22,29,18,33,102
586,28,31,25,28,112
587,16,23,20,21,80
588,27,31,29,23,110
589,26,24,19,31,100
590,18,19,23,31,91
591,17,25,27,25,94
592,18,27,19,24,88
593,26,23,25,21,95
594,19,28,22,18,87
595,30,27,20,27,104
596,25,26,26,34,111
597,23,24,21,26,94
598,23,31,18,23,95
599,22,19,19,20,80
600,30,28,20,27,105
601,26,23,24,23,96
602,32,22,30,28,112
603,28,28,27,24,107
604,28,15,23,23,89
605,21,35,28,26,110
606,19,26,24,22,91
607,23,26,27,18,94
608,24,28,27,25,104
609,30,38,29,23,120
610,27,29,26,22,104
611,25,29,27,23,104
612,31,34,17,26,108
613,27,24,25,16,92
614,18,25,17,16,76
615,31,29,22,20,102
616,30,25,23,34,112
617,25,22,21,23,91
618,22,30,29,18,99
619,25,24,23,23,95
620,30,35,30,28,123
621,22,32,26,32,112
622,20,20,21,23,84
623,23,27,30,28,108
624,17,27,27,30,101
625,23,19,31,28,101
626,39,21,28,33,121
627,25,31,29,32,117
628,24,25,31,25,105
629,25,26,17,22,90
630,18,27,22,19,86
631,24,16,23,22,85
632,23,24,24,21,92
633,18,26,22,30,96
634,16,25,25,27,93
635,21,29,25,27,102
636,21,21,27,23,92
637,21,22,20,21,84
638,25,26,24,31,106
639,27,30,30,30,117
640,22,26,26,24,98
641,28,22,33,35,118
642,20,30,30,29,109
643,27,27,16,22,92
644,24,24,21,35,104
645,17,23,26,25,91
646,21,24,19,29,93
647,24,21,28,23,96
648,28,28,34,32,122
649,23,33,24,26,106
650,27,32,14,26,99
651,21,34,21,20,96
652,31,24,24,26,105
653,28,20,28,33,109
654,20,31,24,27,102
655,31,18,30,25,104
656,26,32,24,20,102
657,24,30,28,25,107
658,23,29,18,32,102
659,16,27,25,24,92
660,26,30,31,23,110
661,25,32,22,16,95
662,29,37,29,19,114
663,23,31,27,14,95
664,23,33,22,23,101
665,24,23,26,41,114
666,24,33,28,24,109
667,24,29,26,27,106
668,21,31,27,31,110
669,21,23,31,38,113
670,29,24,27,24,104
671,21,24,33,21,99
672,25,24,34,17,100
673,26,28,19,29,102
674,26,31,27,24,108
675,28,30,28,29,115
676,23,26,21,18,88
677,26,21,19,23,89
678,23,30,29,30,112
679,27,27,22,28,104
680,31,26,17,27,101
681,28,28,21,35,112
682,24,26,25,24,99
683,27,22,22,21,92
684,23,28,20,24,95
685,27,24,19,24,94
686,24,26,31,23,104
687,21,22,27,27,97
688,21,24,29,21,95
689,19,22,21,26,88
690,26,27,22,24,99
691,28,25,19,25,97
692,18,28,39,27,112
693,28,32,23,28,111
694,21,30,14,30,95
695,21,24,24,21,90
696,28,34,21,20,103
697,27,25,27,27,106
698,16,25,20,17,78
699,24,27,19,20,90
700,32,27,24,20,103
701,29,24,35,19,107
702,25,32,26,22,105
703,17,23,18,27,85
704,27,25,33,25,110
705,20,33,23,22,98
706,27,30,29,26,112
707,25,18,27,28,98
708,29,29,23,15,96
709,25,23,21,28,97
710,23,33,22,19,97
711,17,22,19,10,68
712,30,20,25,22,97
713,18,28,11,22,79
714,18,25,26,24,93
715,26,27,27,23,103
716,32,31,33,33,129
717,27,34,25,27,113
718,29,22,23,26,100
719,22,24,18,33,97
720,23,22,25,27,97
721,31,28,20,20,99
722,29,31,32,31,123
723,25,26,30,22,103
724,23,30,26,25,104
725,29,33,27,21,110
726,30,26,17,22,95
727,21,24,19,24,88
728,18,18,22,20,78
729,26,36,29,18,109
730,16,25,24,19,84
731,23,24,16,29,92
732,23,27,30,22,102
733,24,24,16,21,85
734,22,23,21,28,94
735,27,34,27,25,113
736,25,26,22,20,93
737,16,31,19,30,96
738,20,23,20,28,91
739,29,25,21,20,95
740,21,25,17,23,86
741,24,27,24,29,104
742,31,28,19,25,103
743,24,19,28,21,92
744,29,19,16,23,87
745,31,25,16,24,96
746,23,25,20,23,91
747,25,36,17,28,106
748,24,24,22,19,89
749,30,32,27,22,111
750,23,33,29,19,104
751,20,24,21,32,97
752,31,27,35,28,121
753,22,23,20,35,100
754,26,27,21,22,96
755,23,27,19,26,95
756,29,22,16,29,96
757,19,27,19,23,88
758,25,21,14,22,82
759,30,29,20,32,111
760,22,29,30,26,107
761,26,29,24,22,101
762,27,24,26,26,103
763,22,29,33,27,111
764,21,24,16,19,80
765,33,29,24,28,114
766,23,28,32,27,110
767,20,30,22,28,100
768,17,31,25,24,97
769,21,25,31,23,100
770,29,32,24,29,114
771,30,24,27,26,107
772,24,29,25,23,101
773,22,34,35,16,107
774,26,25,27,18,96
775,26,25,16,29,96
776,26,36,29,33,124
777,23,24,27,28,102
778,32,37,21,24,114
779,20,22,19,22,83
780,20,22,25,25,92
781,21,27,21,24,93
782,20,26,12,31,89
783,20,25,23,19,87
784,29,35,33,25,122
785,25,30,17,28,100
786,31,25,24,26,106
787,24,23,20,24,91
788,28,42,16,25,111
789,25,28,31,32,116
790,19,23,29,20,91
791,25,25,21,22,93
792,31,23,25,31,110
793,26,26,32,22,106
794,26,27,28,27,108
795,18,20,26,27,91
796,16,22,18,31,87
797,22,25,37,27,111
798,28,24,23,28,103
799,26,30,14,27,97
800,25,27,16,18,86
801,21,26,25,18,90
802,24,26,16,33,99
803,30,24,33,21,108
804,19,27,23,35,104
805,25,24,25,23,97
806,25,32,20,24,101
807,22,27,25,26,100
808,24,31,27,15,97
809,22,28,24,18,92
810,39,29,21,31,120
811,34,22,25,26,107
812,27,29,30,25,111
813,22,38,32,21,113
814,19,34,26,21,100
815,23,30,27,24,104
816,22,34,17,22,95
817,24,22,23,21,90
818,29,26,28,18,101
819,21,38,20,23,102
820,17,36,25,23,101
821,23,25,29,17,94
822,34,23,25,29,111
823,17,34,24,31,106
824,24,39,29,22,114
825,25,28,22,22,97
826,26,19,32,21,98
827,21,32,19,24,96
828,29,28,26,22,105
829,20,27,28,14,89
830,32,24,23,18,97
831,25,37,26,35,123
832,28,27,23,27,105
833,21,23,20,26,90
834,24,25,35,33,117
835,21,29,29,25,104
836,17,30,19,21,87
837,27,23,21,33,104
838,19,27,22,28,96
839,24,26,22,27,99
840,27,27,19,21,94
841,29,30,20,27,106
842,28,26,29,17,100
843,30,30,19,21,100
844,33,28,23,17,101
845,21,23,25,30,99
846,29,29,20,26,104
847,23,28,32,24,107
848,30,25,27,14,96
849,23,25,26,35,109
850,30,28,24,27,109
851,24,22,27,20,93
852,17,33,31,30,111
853,21,22,19,21,83
854,29,18,28,27,102
855,21,34,28,15,98
856,29,33,27,28,117
857,24,23,23,30,100
858,23,28,22,33,106
859,25,27,30,31,113
860,29,31,23,19,102
861,34,30,24,30,118
862,26,36,28,21,111
863,13,13,23,26,75
864,23,25,23,17,88
865,21,23,21,17,82
866,28,28,26,20,102
867,21,27,16,30,94
868,18,29,24,28,99
869,19,19,22,24,84
870,25,28,27,28,108
871,26,23,18,29,96
872,22,32,18,25,97
873,22,22,25,24,93
874,26,23,35,26,110
875,21,26,30,24,101
876,24,21,21,23,89
877,27,30,28,24,109
878,35,35,23,26,119
879,27,26,15,25,93
880,20,28,25,30,103
881,24,23,20,28,95
882,23,29,19,27,98
883,27,28,23,27,105
884,23,32,24,20,99
885,30,31,21,21,103
886,28,26,26,20,100
887,25,23,26,22,96
888,21,22,23,26,92
889,22,26,21,17,86
890,24,29,24,27,104
891,17,31,21,19,88
892,18,23,17,20,78
893,12,21,33,25,91
894,21,30,17,28,96
895,26,34,26,19,105
896,22,29,22,33,106
897,18,29,29,28,104
898,31,33,14,26,104
899,22,31,20,14,87
900,21,35,18,28,102
901,22,25,16,25,88
902,22,19,19,22,82
903,23,28,25,25,101
904,29,27,20,25,101
905,22,26,19,29,96
906,25,34,22,33,114
907,15,27,23,16,81
908,28,27,21,18,94
909,29,25,27,25,106
910,22,28,20,28,98
911,20,27,17,30,94
912,22,25,9,24,80
913,25,24,33,27,109
914,22,37,21,18,98
915,17,28,19,22,86
916,28,28,22,23,101
917,27,24,21,21,93
918,21,30,25,31,107
919,19,22,23,23,87
920,21,25,27,23,96
921,19,21,19,25,84
922,27,23,27,29,106
923,29,29,25,28,111
924,21,29,23,27,100
925,32,22,24,27,105
926,21,29,26,25,101
927,19,19,23,21,82
928,24,22,29,33,108
929,21,32,20,19,92
930,15,24,32,18,89
931,33,35,14,27,109
932,33,24,17,20,94
933,22,23,26,16,87
934,26,26,29,26,107
935,18,25,20,21,84
936,17,25,24,25,91
937,23,39,18,35,115
938,31,20,23,29,103
939,31,28,19,29,107
940,26,30,22,14,92
941,24,31,19,25,99
942,24,20,24,30,98
943,25,35,21,30,111
944,23,27,30,31,111
945,25,30,18,27,100
946,22,23,29,29,103
947,16,22,28,26,92
948,22,26,25,22,95
949,18,25,27,20,90
950,23,24,26,32,105
951,36,31,30,24,121
952,22,28,27,26,103
953,27,19,21,24,91
954,25,25,17,15,82
955,31,20,26,24,101
956,40,35,19,20,114
957,22,26,17,26,91
958,29,32,20,33,114
959,27,26,22,28,103
960,26,25,27,29,107
961,34,31,27,17,109
962,23,22,28,24,97
963,31,30,14,42,117
964,24,24,20,18,86
965,35,26,22,15,98
966,31,18,30,30,109
967,34,33,18,28,113
968,34,26,21,22,103
969,37,19,25,17,98
970,22,30,24,29,105
971,29,34,27,20,110
972,19,34,25,30,108
973,27,26,18,18,89
974,20,32,27,27,106
975,23,28,25,21,97
976,26,22,24,24,96
977,19,24,18,23,84
978,35,26,20,30,111
979,26,25,27,23,101
980,26,26,16,26,94
981,26,23,22,27,98
982,38,24,27,25,114
983,24,27,17,26,94
984,22,23,22,29,96
985,21,19,32,24,96
986,20,27,19,22,88
987,27,29,20,22,98
988,14,29,23,26,92
989,18,34,36,26,114
990,24,30,20,24,98
991,20,22,23,15,80
992,33,28,20,16,97
993,23,27,31,21,102
994,22,17,28,20,87
995,19,29,19,22,89
996,23,22,28,19,92
997,24,24,24,27,99
998,24,29,27,28,108
999,17,25,34,25,101
1000,27,21,25,28,101
1001,18,24,25,23,90
1002,22,41,23,22,108
1003,24,36,24,33,117
1004,17,24,18,26,85
1005,35,31,21,23,110
1006,24,29,22,16,91
1007,15,24,31,23,93
1008,34,34,24,21,113
1009,20,29,28,25,102
1010,25,25,25,29,104
1011,18,16,27,24,85
1012,25,18,24,22,89
1013,30,24,29,18,101
1014,29,33,42,28,132
1015,30,28,22,15,95
1016,37,21,22,34,114
1017,22,30,26,29,107
1018,28,20,23,30,101
1019,17,26,32,23,98
1020,24,31,20,25,100
1021,26,39,21,29,115
1022,24,27,20,25,96
1023,24,23,17,33,97
1024,33,39,27,25,124
1025,34,26,18,34,112
1026,27,26,20,14,87
1027,21,25,16,26,88
1028,22,24,25,27,98
1029,24,28,17,31,100
1030,31,34,26,23,114
1031,15,32,23,26,96
1032,29,23,25,24,101
1033,30,25,20,21,96
1034,24,34,29,23,110
1035,25,20,25,21,91
1036,25,23,24,22,94
1037,28,27,22,23,100
1038,23,28,19,31,101
1039,18,30,25,31,104
1040,20,27,22,22,91
1041,24,20,21,16,81
1042,22,24,20,17,83
1043,30,24,19,19,92
1044,20,23,25,18,86
1045,23,24,23,22,92
1046,26,31,28,30,115
1047,23,26,21,30,100
1048,25,26,22,17,90
1049,21,20,31,25,97
1050,28,24,14,19,85
1051,21,28,29,17,95
1052,28,22,21,28,99
1053,22,26,22,24,94
1054,26,35,19,25,105
1055,21,35,15,21,92
1056,28,31,22,30,111
1057,25,23,13,28,89
1058,27,21,19,19,86
1059,30,25,23,27,105
1060,22,31,16,20,89
1061,25,35,26,19,105
1062,24,35,22,17,98
1063,25,33,23,25,106
1064,24,19,28,19,90
1065,24,21,20,29,94
1066,18,27,20,19,84
1067,20,29,33,22,104
1068,15,23,24,23,85
1069,21,19,20,30,90
1070,19,34,35,20,108
1071,23,27,29,22,101
1072,26,27,24,29,106
1073,25,30,28,18,101
1074,21,25,16,27,89
1075,31,25,25,29,110
1076,24,24,21,24,93
1077,17,28,16,28,89
1078,27,31,22,29,109
1079,27,36,25,32,120
1080,27,25,25,22,99
1081,25,28,20,25,98
1082,31,34,22,26,113
1083,27,32,23,23,105
1084,21,25,24,24,94
1085,21,27,17,31,96
1086,22,23,18,22,85
1087,23,29,23,30,105
1088,28,28,22,15,93
1089,25,30,21,36,112
1090,37,28,27,25,117
1091,21,24,22,24,91
1092,21,31,20,24,96
1093,24,27,19,19,89
1094,27,33,29,21,110
1095,25,34,29,20,108
1096,23,32,22,18,95
1097,21,37,25,19,102
1098,24,33,25,21,103
1099,30,27,24,26,107
1100,35,25,26,26,112
1101,21,25,22,33,101
1102,20,24,21,27,92
1103,27,33,22,18,100
1104,27,27,20,29,103
1105,27,24,26,23,100
1106,34,28,24,18,104
1107,21,34,19,28,102
1108,33,26,22,22,103
1109,36,28,20,27,111
1110,29,30,13,20,92
1111,17,36,26,19,98
1112,22,22,19,23,86
1113,20,30,18,31,99
1114,27,25,21,28,101
1115,21,30,24,18,93
1116,20,25,21,24,90
1117,29,25,25,32,111
1118,27,28,27,16,98
1119,18,32,29,27,106
1120,24,27,26,28,105
1121,16,24,25,15,80
1122,22,30,20,21,93
1123,23,24,21,29,97
1124,17,33,20,23,93
1125,20,28,19,22,89
1126,18,36,24,24,102
1127,15,36,30,21,102
1128,18,29,24,25,96
1129,27,33,21,21,102
1130,26,26,20,20,92
1131,22,14,19,21,76
1132,28,33,19,28,108
1133,20,36,28,22,106
1134,28,33,22,29,112
1135,28,33,21,16,98
1136,23,24,20,31,98
1137,22,30,19,29,100
1138,26,26,28,23,103
1139,25,30,24,25,104
1140,23,34,20,26,103
1141,28,20,19,25,92
1142,19,28,16,20,83
1143,23,25,29,27,104
1144,16,26,22,17,81
1145,26,35,30,27,118
1146,29,30,13,22,94
1147,22,33,25,24,104
1148,21,28,17,28,94
1149,21,33,26,25,105
1150,17,33,20,26,96
1151,31,27,27,22,107
1152,25,26,17,22,90
1153,28,27,31,26,112
1154,28,26,28,30,112
1155,23,26,32,26,107
1156,28,20,24,21,93
1157,25,28,24,30,107
1158,26,29,21,27,103
1159,15,31,17,16,79
1160,28,30,30,21,109
1161,26,32,23,23,104
1162,28,19,28,22,97
1163,27,24,29,21,101
1164,32,32,25,23,112
1165,22,25,18,26,91
1166,23,31,19,20,93
1167,25,29,30,21,105
1168,26,25,24,23,98
1169,15,23,24,19,81
1170,25,31,18,25,99
1171,28,23,19,17,87
1172,19,39,20,23,101
1173,26,35,25,29,115
1174,29,24,18,34,105
1175,18,32,27,27,104
1176,31,35,26,26,118
1177,35,35,27,28,125
1178,22,34,27,21,104
1179,28,29,27,25,109
1180,30,32,25,21,108
1181,29,28,36,20,113
1182,16,24,23,22,85
1183,20,29,22,25,96
1184,34,29,23,26,112
1185,25,29,21,29,104
1186,25,25,20,26,96
1187,28,25,17,26,96
1188,25,33,24,26,108
1189,15,27,27,31,100
1190,14,23,21,24,82
1191,16,32,25,19,92
1192,23,27,22,28,100
1193,24,22,22,24,92
1194,29,32,31,33,125
1195,18,27,28,17,90
1196,21,32,31,29,113
1197,28,25,14,18,85
1198,23,20,37,22,102
1199,22,22,18,22,84
1200,25,23,18,22,88
1201,25,28,26,25,104
1202,28,23,23,24,98
1203,24,23,22,18,87
1204,24,26,32,20,102
1205,31,28,23,21,103
1206,19,29,22,32,102
1207,21,26,20,18,85
1208,34,26,22,28,110
1209,26,31,24,23,104
1210,25,21,28,18,92
1211,25,23,25,21,94
1212,18,24,25,26,93
1213,25,33,34,29,121
1214,26,30,28,20,104
1215,13,21,27,27,88
1216,28,24,22,26,100
1217,18,27,22,24,91
1218,22,18,27,22,89
1219,16,19,33,28,96
1220,29,25,23,21,98
1221,28,28,17,24,97
1222,18,35,23,30,106
1223,20,26,22,23,91
1224,22,28,26,32,108
1225,26,32,21,25,104
1226,39,36,19,21,115
1227,23,21,24,34,102
1228,38,31,31,22,122
1229,25,23,24,29,101
1230,19,28,20,20,87
1231,20,30,27,26,103
1232,21,22,19,22,84
1233,25,28,23,27,103
1234,28,24,26,30,108
1235,25,32,24,32,113
1236,26,23,28,31,108
1237,30,25,22,26,103
1238,28,30,22,22,102
1239,20,35,20,28,103
1240,31,31,32,28,122
1241,27,31,35,26,119
1242,21,31,25,18,95
1243,22,23,33,27,105
1244,25,26,23,23,97
1245,34,18,20,21,93
1246,24,36,22,28,110
1247,25,33,19,22,99
1248,28,28,25,29,110
1249,15,21,15,30,81
1250,21,26,29,26,102
1251,24,29,23,25,101
1252,15,27,25,18,85
1253,27,25,24,30,106
1254,17,23,17,23,80
1255,30,20,26,14,90
1256,27,22,32,29,110
1257,26,26,28,24,104
1258,29,23,27,23,102
1259,17,23,16,27,83
1260,27,28,24,24,103
1261,25,29,24,26,104
1262,26,26,29,21,102
1263,26,20,20,13,79
1264,32,34,21,20,107
1265,24,25,22,16,87
1266,34,28,25,19,106
1267,29,19,19,19,86
1268,18,19,24,17,78
1269,24,31,22,28,105
1270,27,34,22,24,107
1271,28,27,27,21,103
1272,22,27,29,24,102
1273,18,36,18,25,97
1274,25,36,18,21,100
1275,26,24,22,20,92
1276,23,29,26,24,102
1277,24,28,17,24,93
1278,32,26,22,26,106
1279,25,29,30,29,113
1280,28,26,26,23,103
1281,18,24,19,20,81
1282,19,28,23,27,97
1283,36,28,15,31,110
1284,28,36,21,30,115
1285,28,33,16,23,100
1286,30,21,31,23,105
1287,26,26,29,17,98
1288,15,34,38,22,109
1289,23,26,25,25,99
1290,30,28,22,27,107
1291,24,31,26,22,103
1292,23,21,29,24,97
1293,34,26,30,30,120
1294,31,25,24,16,96
1295,19,27,33,22,101
1296,19,29,23,13,84
1297,20,23,25,23,91
1298,22,29,17,23,91
1299,18,28,26,24,96
1300,28,29,19,27,103
1301,21,29,20,27,97
1302,25,34,34,33,126
1303,24,12,21,18,75
1304,22,24,28,22,96
1305,29,23,33,25,110
1306,26,28,21,29,104
1307,28,38,27,21,114
1308,19,21,26,22,88
1309,28,27,28,28,111
1310,26,21,18,18,83
1311,16,41,25,14,96
1312,30,22,35,20,107
1313,26,25,24,26,101
1314,17,17,22,27,83
1315,27,24,20,26,97
1316,24,25,25,29,103
1317,29,35,26,20,110
1318,22,19,16,21,78
1319,24,27,24,29,104
1320,28,21,17,33,99
1321,17,24,13,21,75
1322,26,23,20,24,93
1323,26,22,27,21,96
1324,34,24,30,32,120
1325,19,32,17,23,91
1326,26,36,24,15,101
1327,22,30,26,27,105
1328,34,28,21,23,106
1329,25,25,15,23,88
1330,28,25,19,23,95
1331,17,30,26,32,105
1332,22,35,25,26,108
1333,21,34,27,24,106
1334,30,26,29,28,113
1335,33,30,29,34,126
1336,23,24,18,24,89
1337,31,30,34,18,113
1338,38,26,27,29,120
1339,18,29,29,32,108
1340,22,33,28,22,105
1341,28,24,22,15,89
1342,20,32,34,22,108
1343,28,22,27,27,104
1344,27,31,23,20,101
1345,28,36,20,34,118
1346,29,23,19,24,95
1347,31,28,19,23,101
1348,24,20,19,22,85
1349,28,35,20,28,111
1350,30,22,19,16,87
1351,27,31,29,25,112
1352,28,29,33,34,124
1353,31,27,27,21,106
1354,21,22,23,20,86
1355,25,28,17,24,94
1356,24,25,19,23,91
1357,26,27,22,27,102
1358,18,24,24,24,90
1359,28,18,22,19,87
1360,21,26,23,18,88
1361,31,38,25,25,119
1362,22,19,25,22,88
1363,21,29,28,14,92
1364,24,26,27,28,105
1365,13,29,24,19,85
1366,24,21,20,24,89
1367,22,32,18,23,95
1368,20,26,18,21,85
1369,29,19,18,19,85
1370,21,28,25,27,101
1371,26,31,24,24,105
1372,34,26,22,27,109
1373,23,21,19,24,87
1374,24,34,24,22,104
1375,30,33,34,25,122
1376,19,28,25,22,94
1377,25,28,16,22,91
1378,25,17,27,23,92
1379,24,22,30,23,99
1380,34,30,27,21,112
1381,26,25,26,26,103
1382,21,30,22,23,96
1383,24,29,30,26,109
1384,27,20,19,26,92
1385,25,30,32,20,107
1386,25,25,25,37,112
1387,22,38,19,32,111
1388,24,19,23,28,94
1389,18,21,17,10,66
1390,21,32,20,24,97
1391,32,30,17,25,104
1392,23,32,24,18,97
1393,27,29,24,27,107
1394,25,23,30,19,97
1395,29,25,18,28,100
1396,22,27,21,20,90
1397,21,28,26,24,99
1398,31,28,24,17,100
1399,17,34,22,30,103
1400,27,22,30,34,113
1401,22,23,22,19,86
1402,19,36,28,30,113
1403,18,29,21,34,102
1404,22,23,28,18,91
1405,27,29,20,25,101
1406,23,25,22,14,84
1407,19,25,26,21,91
1408,28,29,19,20,96
1409,25,30,17,25,97
1410,28,26,26,28,108
1411,15,17,16,30,78
1412,29,27,24,18,98
1413,26,25,27,22,100
1414,18,23,22,26,89
1415,24,24,17,24,89
1416,18,35,21,29,103
1417,24,24,20,26,94
1418,21,29,20,22,92
1419,24,29,22,22,97
1420,32,33,21,20,106
1421,24,24,37,27,112
1422,25,25,19,31,100
1423,27,31,21,28,107
1424,36,27,19,30,112
1425,32,29,28,23,112
1426,22,22,17,25,86
1427,18,36,21,27,102
1428,25,30,20,26,101
1429,19,24,21,25,89
1430,18,26,21,29,94
1431,21,34,18,32,105
1432,30,26,17,24,97
1433,21,28,25,22,96
1434,21,23,18,25,87
1435,25,20,25,24,94
1436,29,27,36,18,110
1437,25,36,28,23,112
1438,26,33,16,24,99
1439,28,23,29,30,110
1440,13,26,33,31,103
1441,29,26,20,15,90
1442,26,30,28,16,100
1443,20,32,22,24,98
1444,27,31,28,26,112
1445,22,18,23,29,92
1446,29,27,33,27,116
1447,22,28,24,22,96
1448,21,33,16,18,88
1449,26,23,32,31,112
1450,19,25,24,22,90
1451,30,29,17,25,101
1452,26,24,22,21,93
1453,23,25,30,21,99
1454,28,29,29,33,119
1455,24,30,21,29,104
1456,28,26,24,23,101
1457,25,25,22,30,102
1458,20,22,21,26,89
1459,18,29,27,25,99
1460,24,31,23,25,103
1461,31,32,26,27,116
1462,22,31,23,20,96
1463,29,20,23,18,90
1464,33,31,29,16,109
1465,22,17,22,24,85
1466,27,26,21,28,102
1467,25,26,27,18,96
1468,23,25,29,35,112
1469,20,21,21,30,92
1470,23,34,24,22,103
1471,23,32,27,25,107
1472,19,27,18,31,95
1473,29,27,25,24,105
1474,25,25,27,26,103
1475,22,24,28,28,102
1476,28,25,17,16,86
1477,15,33,20,23,91
1478,20,32,30,21,103
1479,30,29,23,19,101
1480,21,31,22,18,92
1481,30,31,24,25,110
1482,20,26,35,23,104
1483,25,23,16,24,88
1484,20,21,20,28,89
1485,29,33,31,23,116
1486,32,20,27,30,109
1487,28,38,28,21,115
1488,24,24,21,21,90
1489,18,27,30,24,99
1490,19,29,30,22,100
1491,21,23,21,20,85
1492,19,33,22,28,102
1493,16,26,29,29,100
1494,23,25,17,30,95
1495,27,31,22,25,105
1496,26,27,29,14,96
1497,21,24,23,36,104
1498,26,33,23,23,105
1499,24,26,18,17,85
1500,19,24,30,31,104
1501,25,26,17,21,89
1502,30,35,21,22,108
1503,22,23,28,20,93
1504,23,35,23,18,99
1505,20,33,17,27,97
1506,27,26,21,30,104
1507,23,22,18,24,87
1508,32,25,23,17,97
1509,16,27,30,24,97
1510,24,30,29,20,103
1511,22,25,25,23,95
1512,19,25,20,19,83
1513,38,24,30,25,117
1514,16,29,28,22,95
1515,27,28,26,17,98
1516,34,33,16,23,106
1517,18,22,26,19,85
1518,38,30,16,33,117
1519,19,21,22,26,88
1520,22,31,29,29,111
1521,23,30,25,26,104
1522,26,32,11,21,90
1523,20,28,28,26,102
1524,22,16,35,19,92
1525,23,22,23,28,96
1526,31,31,20,29,111
1527,28,29,25,31,113
1528,26,27,29,29,111
1529,25,34,16,18,93
1530,26,27,22,21,96
1531,20,21,20,27,88
1532,33,21,26,26,106
1533,15,21,26,21,83
1534,28,31,24,34,117
1535,25,28,20,23,96
1536,24,24,30,27,105
1537,26,32,15,28,101
1538,31,31,22,16,100
1539,31,33,14,19,97
1540,19,33,22,24,98
1541,25,37,16,31,109
1542,19,26,27,24,96
1543,25,27,28,25,105
1544,24,31,31,27,113
1545,22,35,21,21,99
1546,38,23,23,24,108
1547,23,35,35,28,121
1548,18,33,27,21,99
1549,19,24,26,29,98
1550,24,30,17,22,93
1551,31,28,23,24,106
1552,19,26,30,23,98
1553,29,28,20,23,100
1554,28,26,26,25,105
1555,16,31,30,29,106
1556,25,26,17,24,92
1557,25,28,28,36,117
1558,24,34,27,27,112
1559,23,20,26,22,91
1560,23,35,21,20,99
1561,24,27,15,28,94
1562,29,31,18,29,107
1563,24,29,25,18,96
1564,18,27,26,23,94
1565,23,31,18,19,91
1566,24,24,33,34,115
1567,32,20,22,19,93
1568,21,34,22,19,96
1569,29,27,26,19,101
1570,21,24,31,35,111
1571,22,24,23,28,97
1572,25,29,22,28,104
1573,13,25,20,30,88
1574,26,28,19,19,92
1575,20,36,33,29,118
1576,25,25,15,21,86
1577,26,26,29,26,107
1578,26,35,27,20,108
1579,26,33,26,21,106
1580,18,23,24,23,88
1581,19,27,24,27,97
1582,28,31,25,28,112
1583,26,28,27,24,105
1584,32,29,29,16,106
1585,22,27,19,26,94
1586,24,24,20,25,93
1587,29,27,23,30,109
1588,22,23,21,33,99
1589,28,26,29,33,116
1590,21,22,21,29,93
1591,24,27,18,20,89
1592,17,31,31,36,115
1593,24,30,22,18,94
1594,25,23,22,29,99
1595,22,26,26,14,88
1596,26,22,20,26,94
1597,30,21,26,28,105
1598,22,25,28,31,106
1599,31,29,26,17,103
1600,18,24,24,15,81
1601,22,20,25,21,88
1602,21,22,25,22,90
1603,21,26,23,17,87
1604,19,25,22,22,88
1605,26,23,28,26,103
1606,32,22,22,18,94
1607,18,24,28,42,112
1608,26,26,19,29,100
1609,24,26,22,29,101
1610,23,23,20,25,91
1611,31,27,21,25,104
1612,25,19,25,15,84
1613,24,28,16,22,90
1614,24,26,22,30,102
1615,33,27,24,25,109
1616,31,34,29,41,135
1617,27,26,27,23,103
1618,23,29,22,34,108
1619,21,24,28,22,95
1620,24,20,21,32,97
1621,23,29,24,20,96
1622,27,24,21,24,96
1623,22,31,25,25,103
1624,23,28,24,32,107
1625,25,37,18,29,109
1626,35,28,22,24,109
1627,19,31,16,19,85
1628,28,25,17,18,88
1629,26,30,25,22,103
1630,27,34,16,23,100
1631,24,30,32,35,121
1632,24,25,19,19,87
1633,22,27,30,30,109
1634,24,22,24,17,87
1635,26,27,23,23,99
1636,26,30,28,20,104
1637,30,26,22,17,95
1638,21,23,33,27,104
1639,26,27,29,30,112
1640,22,22,20,20,84
1641,19,28,28,23,98
1642,14,18,20,25,77
1643,17,25,20,26,88
1644,29,35,30,22,116
1645,24,26,20,24,94
1646,30,26,25,17,98
1647,24,31,25,23,103
1648,22,33,22,28,105
1649,25,27,27,29,108
1650,18,25,28,24,95
1651,23,21,18,22,84
1652,33,29,18,22,102
1653,39,30,33,27,129
1654,27,26,18,19,90
1655,33,24,28,25,110
1656,24,28,27,28,107
1657,21,27,21,25,94
1658,31,35,20,25,111
1659,32,23,28,27,110
1660,24,32,19,15,90
1661,31,28,33,30,122
1662,26,35,26,24,111
1663,21,27,20,24,92
1664,30,22,20,30,102
1665,28,26,31,26,111
1666,20,31,20,18,89
1667,29,30,22,29,110
1668,31,27,19,22,99
1669,22,27,18,32,99
1670,31,22,25,31,109
1671,21,26,16,27,90
1672,22,28,17,26,93
1673,26,34,22,21,103
1674,30,32,38,24,124
1675,27,27,25,29,108
1676,29,32,24,19,104
1677,14,28,18,24,84
1678,25,29,23,19,96
1679,26,28,21,32,107
1680,30,30,32,23,115
1681,22,33,13,20,88
1682,24,41,21,28,114
1683,28,20,14,32,94
1684,28,34,32,28,122
1685,23,29,21,24,97
1686,31,36,26,14,107
1687,25,35,22,23,105
1688,19,26,21,23,89
1689,20,28,13,19,80
1690,23,19,19,26,87
1691,20,30,14,32,96
1692,27,37,28,23,115
1693,32,29,33,28,122
1694,17,29,26,18,90
1695,22,23,21,23,89
1696,22,29,27,23,101
1697,31,24,24,28,107
1698,26,27,23,31,107
1699,29,32,31,29,121
1700,23,21,20,27,91
1701,22,25,22,22,91
1702,22,26,23,32,103
1703,24,30,17,22,93
1704,22,28,25,23,98
1705,20,38,35,29,122
1706,13,33,30,20,96
1707,28,27,20,37,112
1708,30,26,24,18,98
1709,22,27,25,26,100
1710,22,29,28,34,113
1711,32,35,28,17,112
1712,28,26,22,23,99
1713,24,20,17,19,80
1714,20,36,25,19,100
1715,26,22,26,27,101
1716,24,38,27,21,110
1717,24,31,16,25,96
1718,22,32,30,25,109
1719,22,26,14,20,82
1720,36,26,25,24,111
1721,25,26,23,26,100
1722,20,27,25,21,93
1723,32,32,12,23,99
1724,28,26,24,26,104
1725,27,33,24,21,105
1726,14,28,29,31,102
1727,27,25,23,25,100
1728,19,25,24,26,94
1729,21,34,17,28,100
1730,23,27,32,31,113
1731,23,34,20,19,96
1732,16,35,24,29,104
1733,16,31,15,26,88
1734,25,30,24,24,103
1735,31,34,17,23,105
1736,22,24,15,14,75
1737,25,27,18,28,98
1738,35,28,19,25,107
1739,35,32,30,27,124
1740,22,39,29,29,119
1741,23,35,27,31,116
1742,21,33,34,20,108
1743,24,29,24,30,107
1744,25,25,24,23,97
1745,17,34,27,24,102
1746,21,40,23,18,102
1747,33,28,20,26,107
1748,23,23,26,37,109
1749,30,23,26,15,94
1750,22,25,29,29,105
1751,21,20,18,23,82
1752,29,29,21,30,109
1753,18,27,25,17,87
1754,24,26,21,17,88
1755,31,32,31,21,115
1756,20,28,22,19,89
1757,33,30,25,21,109
1758,19,24,31,24,98
1759,20,20,27,24,91
1760,26,25,21,30,102
1761,19,24,26,25,94
1762,22,23,29,23,97
1763,20,37,27,24,108
1764,32,26,20,30,108
1765,26,35,23,35,119
1766,23,32,26,24,105
1767,23,26,17,21,87
1768,25,25,18,20,88
1769,33,27,14,25,99
1770,22,35,27,25,109
1771,25,19,25,31,100
1772,21,29,29,25,104
1773,23,25,26,23,97
1774,23,25,30,29,107
1775,28,28,24,20,100
1776,22,30,20,24,96
1777,21,33,27,24,105
1778,23,27,27,23,100
1779,24,39,36,16,115
1780,24,27,20,22,93
1781,25,25,18,34,102
1782,23,23,31,24,101
1783,33,22,22,30,107
1784,24,25,27,24,100
1785,32,31,18,21,102
1786,27,23,27,33,110
1787,26,21,20,34,101
1788,25,27,29,19,100
1789,23,27,28,30,108
1790,20,31,31,21,103
1791,31,26,20,23,100
1792,25,30,18,23,96
1793,20,22,26,36,104
1794,23,33,20,21,97
1795,26,26,22,25,99
1796,23,25,20,18,86
1797,19,37,18,29,103
1798,33,25,22,30,110
1799,25,34,30,27,116
1800,23,31,21,23,98
1801,33,30,17,36,116
1802,29,33,24,31,117
1803,27,23,27,21,98
1804,27,32,19,33,111
1805,21,26,19,28,94
1806,20,26,26,29,101
1807,22,17,28,40,107
1808,19,23,17,13,72
1809,29,35,20,25,109
1810,24,35,27,26,112
1811,26,22,25,13,86
1812,24,26,23,32,105
1813,26,35,27,24,112
1814,29,25,29,18,101
1815,17,15,22,27,81
1816,31,18,17,27,93
1817,20,27,23,25,95
1818,24,31,28,29,112
1819,22,30,20,19,91
1820,37,33,19,27,116
1821,25,26,32,30,113
1822,26,33,19,25,103
1823,16,25,19,33,93
1824,21,33,18,24,96
1825,28,22,26,20,96
1826,29,19,27,18,93
1827,27,30,16,32,105
1828,29,25,22,22,98
1829,21,40,24,25,110
1830,16,29,23,32,100
1831,28,30,26,23,107
1832,28,23,28,24,103
1833,18,26,27,15,86
1834,18,26,16,24,84
1835,28,25,25,24,102
1836,30,29,20,31,110
1837,29,29,21,31,110
1838,29,32,28,31,120
1839,24,34,20,20,98
1840,30,34,34,20,118
1841,22,32,24,27,105
1842,26,31,17,15,89
1843,16,27,24,25,92
1844,38,20,16,19,93
1845,36,26,19,24,105
1846,33,34,36,20,123
1847,24,24,17,24,89
1848,28,32,25,27,112
1849,29,22,24,30,105
1850,21,27,21,28,97
1851,26,23,19,21,89
1852,27,26,26,22,101
1853,20,26,24,29,99
1854,23,26,19,23,91
1855,23,29,25,18,95
1856,23,23,27,28,101
1857,20,30,24,26,100
1858,30,26,23,25,104
1859,18,26,32,25,101
1860,34,28,23,25,110
1861,21,28,21,18,88
1862,20,25,24,17,86
1863,27,25,30,23,105
1864,14,27,24,30,95
1865,23,26,16,25,90
1866,22,25,26,24,97
1867,32,27,21,23,103
1868,25,32,21,25,103
1869,16,33,23,28,100
1870,26,27,21,33,107
1871,19,27,24,29,99
1872,22,23,26,23,94
1873,19,28,18,21,86
1874,22,32,37,20,111
1875,23,31,30,20,104
1876,20,19,35,25,99
1877,19,23,23,26,91
1878,16,32,25,30,103
1879,17,23,16,27,83
1880,25,27,22,34,108
1881,25,26,26,20,97
1882,26,26,22,23,97
1883,20,30,23,21,94
1884,25,32,28,28,113
1885,26,20,23,30,99
1886,30,31,22,29,112
1887,25,29,21,20,95
1888,26,25,26,30,107
1889,20,32,30,24,106
1890,25,31,19,19,94
1891,25,32,25,17,99
1892,31,13,14,24,82
1893,25,34,31,27,117
1894,25,29,14,21,89
1895,18,18,21,23,80
1896,23,22,26,21,92
1897,30,26,34,22,112
1898,16,18,26,21,81
1899,18,20,22,23,83
1900,27,33,28,20,108
1901,28,30,26,25,109
1902,29,31,18,19,97
1903,28,23,37,20,108
1904,30,28,18,18,94
1905,24,22,21,26,93
1906,31,18,16,27,92
1907,24,35,28,26,113
1908,20,31,22,29,102
1909,29,33,24,26,112
1910,20,25,21,20,86
1911,24,23,15,21,83
1912,24,16,28,21,89
1913,20,29,22,19,90
1914,26,26,24,24,100
1915,31,35,15,30,111
1916,22,31,24,17,94
1917,33,29,31,31,124
1918,25,30,12,26,93
1919,24,34,22,22,102
1920,22,36,30,35,123
1921,27,26,20,32,105
1922,30,28,26,25,109
1923,23,25,18,30,96
1924,19,25,24,29,97
1925,24,29,30,36,119
1926,30,28,27,29,114
1927,20,23,30,25,98
1928,25,21,23,25,94
1929,31,24,17,19,91
1930,42,21,30,25,118
1931,24,36,24,37,121
1932,25,33,24,24,106
1933,19,28,25,26,98
1934,23,31,38,19,111
1935,23,26,28,22,99
1936,31,24,18,23,96
1937,18,31,19,30,98
1938,16,22,20,21,79
1939,24,31,26,25,106
1940,24,24,19,19,86
1941,25,31,28,21,105
1942,31,20,21,29,101
1943,26,30,25,23,104
1944,32,28,20,26,106
1945,18,31,23,23,95
1946,25,30,19,24,98
1947,24,25,20,30,99
1948,16,28,21,21,86
1949,27,36,24,20,107
1950,24,28,19,29,100
1951,24,24,18,25,91
1952,17,31,13,22,83
1953,21,32,31,29,113
1954,19,26,22,32,99
1955,24,22,28,21,95
1956,29,26,26,21,102
1957,20,33,25,24,102
1958,26,22,26,26,100
1959,15,28,29,24,96
1960,29,28,26,20,103
1961,23,23,27,32,105
1962,24,29,23,25,101
1963,23,29,16,20,88
1964,25,32,29,28,114
1965,27,28,21,22,98
1966,24,33,23,34,114
1967,23,31,18,33,105
1968,27,29,25,32,113
1969,21,19,22,23,85
1970,12,32,21,33,98
1971,21,26,31,26,104
1972,25,25,26,19,95
1973,28,34,20,24,106
1974,20,25,16,30,91
1975,26,25,25,23,99
1976,21,34,29,28,112
1977,24,21,24,19,88
1978,23,35,18,31,107
1979,23,18,26,30,97
1980,34,24,32,32,122
1981,18,21,24,21,84
1982,30,29,18,29,106
1983,17,19,23,24,83
1984,25,32,24,28,109
1985,23,27,16,16,82
1986,21,36,16,22,95
1987,17,35,24,28,104
1988,20,22,24,14,80
1989,30,18,27,23,98
1990,20,30,31,35,116
1991,22,24,21,23,90
1992,22,24,23,19,88
1993,28,30,25,40,123
1994,20,19,25,23,87
1995,22,32,18,29,101
1996,15,31,31,21,98
1997,24,31,24,24,103
1998,22,33,19,23,97
1999,21,25,25,26,97
2000,18,24,20,25,87
2001,29,29,25,22,105
2002,24,23,24,37,108
2003,22,27,27,25,101
2004,17,20,21,28,86
2005,26,19,18,18,81
2006,27,19,23,23,92
2007,32,23,22,29,106
2008,26,24,24,30,104
2009,20,27,20,25,92
2010,26,26,27,32,111
2011,15,27,24,16,82
2012,21,26,26,20,93
2013,26,24,23,33,106
2014,30,32,22,27,111
2015,38,29,16,17,100
2016,20,30,23,24,97
2017,21,26,21,28,96
2018,22,19,24,29,94
2019,28,29,22,33,112
2020,27,30,21,22,100
2021,34,23,21,18,96
2022,26,33,22,27,108
2023,26,32,21,27,106
2024,24,23,33,24,104
2025,14,26,29,23,92
2026,19,18,23,22,82
2027,21,18,25,24,88
2028,14,31,15,16,76
2029,27,27,17,19,90
2030,18,27,21,19,85
2031,23,22,25,30,100
2032,25,26,18,34,103
2033,23,27,24,29,103
2034,23,21,16,28,88
2035,30,32,27,27,116
2036,32,30,17,22,101
2037,29,26,27,20,102
2038,32,26,24,24,106
2039,23,20,21,23,87
2040,28,30,24,20,102
2041,25,23,25,21,94
2042,20,25,18,17,80
2043,24,27,28,21,100
2044,16,26,20,22,84
2045,27,22,19,15,83
2046,24,23,21,20,88
2047,32,21,23,22,98
2048,23,25,29,17,94
2049,22,34,22,30,108
2050,29,37,25,21,112
2051,25,29,31,33,118
2052,21,25,22,22,90
2053,28,29,19,31,107
2054,34,34,29,21,118
2055,27,30,24,34,115
2056,19,25,24,22,90
2057,24,31,28,27,110
2058,22,17,26,22,87
2059,23,32,23,16,94
2060,23,30,26,14,93
2061,23,24,32,29,108
2062,29,35,22,22,108
2063,23,24,18,20,85
2064,28,30,13,22,93
2065,22,28,20,23,93
2066,24,20,22,29,95
2067,26,27,30,23,106
2068,27,38,19,25,109
2069,21,24,21,28,94
2070,28,33,24,31,116
2071,20,28,18,24,90
2072,37,19,26,23,105
2073,30,25,27,26,108
2074,18,35,23,33,109
2075,19,23,24,24,90
2076,21,28,32,25,106
2077,26,21,18,20,85
2078,26,19,23,24,92
2079,21,21,14,22,78
2080,32,28,14,19,93
2081,26,30,30,24,110
2082,18,26,13,22,79
2083,27,22,17,17,83
2084,28,20,20,29,97
2085,16,30,28,30,104
2086,22,28,19,19,88
2087,24,27,24,26,101
2088,20,20,20,28,88
2089,33,25,25,26,109
2090,30,28,24,20,102
2091,29,34,31,22,116
2092,18,29,12,17,76
2093,24,31,31,28,114
2094,29,30,18,38,115
2095,25,31,25,28,109
2096,23,25,20,22,90
2097,21,27,18,22,88
2098,27,35,21,19,102
2099,22,30,26,25,103
2100,21,20,20,21,82
2101,21,30,19,21,91
2102,21,22,23,19,85
2103,21,16,24,21,82
2104,33,31,26,25,115
2105,20,26,34,20,100
2106,25,22,22,28,97
2107,21,20,25,18,84
2108,33,32,28,26,119
2109,26,33,29,30,118
2110,26,34,23,28,111
2111,26,26,27,22,101
2112,33,27,18,30,108
2113,20,29,28,23,100
2114,20,24,23,21,88
2115,26,31,23,20,100
2116,23,27,24,37,111
2117,31,34,20,35,120
2118,27,24,27,24,102
2119,24,37,16,25,102
2120,23,25,17,18,83
2121,27,22,20,28,97
2122,25,27,33,24,109
2123,17,34,22,19,92
2124,30,34,23,29,116
2125,18,28,28,32,106
2126,26,32,23,22,103
2127,27,30,22,25,104
2128,22,22,27,33,104
2129,25,27,21,23,96
2130,22,25,17,23,87
2131,33,22,28,27,110
2132,26,18,13,22,79
2133,30,34,28,23,115
2134,25,29,35,17,106
2135,23,21,27,23,94
2136,17,22,25,34,98
2137,10,29,23,25,87
2138,30,23,22,26,101
2139,20,31,28,24,103
2140,23,31,27,23,104
2141,26,36,19,29,110
2142,14,30,18,29,91
2143,26,29,31,26,112
2144,23,27,24,23,97
2145,25,32,19,21,97
2146,20,28,24,35,107
2147,24,35,30,22,111
2148,20,26,17,29,92
2149,24,36,25,30,115
2150,29,35,22,20,106
2151,29,21,13,24,87
2152,23,32,29,21,105
2153,25,37,23,19,104
2154,27,18,28,14,87
2155,22,30,24,22,98
2156,31,28,28,34,121
2157,22,25,25,23,95
2158,19,21,26,27,93
2159,16,25,29,26,96
2160,22,23,25,24,94
2161,30,26,33,22,111
2162,33,33,29,16,111
2163,26,27,30,28,111
2164,32,25,16,28,101
2165,26,28,23,27,104
2166,28,26,22,23,99
2167,17,33,27,26,103
2168,23,28,25,24,100
2169,23,25,28,24,100
2170,22,28,34,21,105
2171,26,17,28,18,89
2172,27,28,19,22,96
2173,22,22,25,21,90
2174,12,23,17,27,79
2175,27,24,23,29,103
2176,31,30,25,22,108
2177,19,39,25,18,101
2178,29,20,24,32,105
2179,25,25,21,26,97
2180,24,34,20,30,108
2181,26,30,22,17,95
2182,36,28,34,32,130
2183,24,28,24,21,97
2184,14,22,16,21,73
2185,21,29,17,25,92
2186,13,26,19,20,78
2187,29,21,22,30,102
2188,21,31,20,26,98
2189,25,33,17,24,99
2190,24,16,30,24,94
2191,26,27,26,26,105
2192,28,33,29,25,115
2193,25,29,22,17,93
2194,27,43,19,20,109
2195,31,27,27,32,117
2196,23,37,22,30,112
2197,25,25,20,23,93
2198,27,20,25,25,97
2199,23,33,25,30,111
2200,28,23,32,38,121
2201,21,31,21,28,101
2202,24,35,23,14,96
2203,25,28,25,24,102
2204,21,27,20,14,82
2205,14,30,28,27,99
2206,20,27,25,24,96
2207,31,20,24,20,95
2208,22,16,10,17,65
2209,31,25,23,26,105
2210,28,20,21,21,90
2211,19,25,26,31,101
2212,19,24,27,30,100
2213,28,22,28,25,103
2214,30,30,22,27,109
2215,26,27,28,34,115
2216,20,24,19,25,88
2217,30,40,26,29,125
2218,16,22,27,24,89
2219,21,21,24,25,91
2220,24,28,30,29,111
2221,27,30,19,27,103
2222,26,34,29,34,123
2223,24,24,23,27,98
2224,25,32,19,26,102
2225,21,29,23,31,104
2226,15,35,23,31,104
2227,28,24,21,25,98
2228,23,22,26,21,92
2229,20,33,29,28,110
2230,17,26,17,15,75
2231,19,29,20,21,89
2232,24,36,23,17,100
2233,25,30,25,28,108
2234,23,25,29,25,102
2235,31,23,22,17,93
2236,20,26,20,37,103
2237,23,28,25,28,104
2238,27,35,33,26,121
2239,27,35,25,25,112
2240,21,38,39,27,125
2241,29,29,24,17,99
2242,19,35,21,25,100
2243,26,24,30,25,105
2244,21,23,20,25,89
2245,25,31,26,23,105
2246,20,22,18,22,82
2247,24,41,21,32,118
2248,24,26,24,26,100
2249,20,26,19,19,84
2250,27,31,19,19,96
2251,37,27,22,21,107
2252,25,28,26,23,102
2253,23,24,22,25,94
2254,22,23,20,24,89
2255,23,27,24,26,100
2256,27,25,22,33,107
2257,26,30,22,22,100
2258,26,23,33,24,106
2259,17,24,34,29,104
2260,35,23,20,30,108
2261,23,23,23,27,96
2262,32,27,23,16,98
2263,25,32,18,23,98
2264,33,31,29,14,107
2265,18,32,20,29,99
2266,28,16,32,32,108
2267,24,29,22,18,93
2268,22,28,25,19,94
2269,22,35,24,19,100
2270,23,36,25,29,113
2271,24,29,32,22,107
2272,23,23,24,20,90
2273,30,30,20,32,112
2274,29,29,23,23,104
2275,25,24,20,31,100
2276,19,33,28,21,101
2277,19,33,19,24,95
2278,22,23,21,24,90
2279,23,31,29,24,107
2280,20,24,24,22,90
2281,30,30,17,26,103
2282,21,20,36,21,98
2283,22,31,17,17,87
2284,19,35,18,27,99
2285,19,29,22,18,88
2286,25,34,20,26,105
2287,21,18,27,26,92
2288,26,29,17,27,99
2289,19,22,21,32,94
2290,19,16,20,28,83
2291,24,31,29,26,110
2292,24,29,26,19,98
2293,23,32,31,30,116
2294,26,28,31,28,113
2295,32,33,22,25,112
2296,21,29,24,22,96
2297,18,32,26,23,99
2298,16,27,18,24,85
2299,23,24,29,21,97
2300,15,24,27,27,93
2301,29,37,29,30,125
2302,27,35,24,30,116
2303,19,32,19,25,95
2304,24,25,30,24,103
2305,30,28,27,19,104
2306,19,28,26,18,91
2307,17,28,22,19,86
2308,22,23,25,30,100
2309,21,22,21,17,81
2310,20,26,25,26,97
2311,30,21,24,17,92
2312,26,28,25,27,106
2313,26,26,25,20,97
2314,18,22,26,19,85
2315,28,31,29,20,108
2316,26,27,24,14,91
2317,24,32,19,26,101
2318,25,33,24,29,111
2319,22,32,26,23,103
2320,23,32,18,26,99
2321,22,31,20,31,104
2322,16,36,19,17,88
2323,25,24,28,29,106
2324,17,28,25,14,84
2325,32,29,22,19,102
2326,17,30,26,32,105
2327,40,24,29,19,112
2328,32,26,34,27,119
2329,18,27,20,17,82
2330,23,29,31,23,106
2331,26,25,26,25,102
2332,25,29,27,25,106
2333,22,21,36,25,104
2334,22,23,21,23,89
2335,30,26,32,27,115
2336,28,27,28,28,111
2337,34,26,22,19,101
2338,23,29,27,18,97
2339,25,29,19,31,104
2340,29,28,20,23,100
2341,30,25,25,11,91
2342,21,29,18,35,103
2343,16,31,28,27,102
2344,24,25,31,23,103
2345,25,32,30,27,114
2346,25,31,25,24,105
2347,19,25,21,24,89
2348,20,17,20,20,77
2349,17,26,21,18,82
2350,25,27,21,18,91
2351,28,26,15,16,85
2352,20,24,20,33,97
2353,14,29,25,35,103
2354,28,23,23,25,99
2355,23,33,28,24,108
2356,20,39,26,29,114
2357,23,25,22,19,89
2358,29,24,29,28,110
2359,24,31,25,25,105
2360,28,27,16,29,100
2361,18,34,23,27,102
2362,28,26,26,20,100
2363,23,30,29,29,111
2364,19,40,18,22,99
2365,23,26,29,23,101
2366,37,25,20,29,111
2367,19,29,23,29,100
2368,29,30,26,23,108
2369,36,29,28,26,119
2370,23,29,27,35,114
2371,34,22,30,23,109
2372,26,19,24,26,95
2373,35,28,19,16,98
2374,37,35,25,27,124
2375,28,27,29,26,110
2376,33,29,18,21,101
2377,24,20,16,25,85
2378,23,25,15,24,87
2379,21,36,28,25,110
2380,30,25,19,22,96
2381,28,23,29,24,104
2382,28,35,22,25,110
2383,21,27,29,26,103
2384,17,21,27,30,95
2385,20,26,17,26,89
2386,22,37,20,18,97
2387,29,26,32,24,111
2388,26,36,24,24,110
2389,17,29,15,20,81
2390,19,33,28,20,100
2391,27,28,24,18,97
2392,26,34,23,25,108
2393,27,24,25,36,112
2394,30,26,24,30,110
2395,25,26,25,16,92
2396,27,31,25,15,98
2397,28,22,29,14,93
2398,16,18,23,24,81
2399,15,28,25,26,94
2400,20,23,31,22,96
2401,27,26,30,24,107
2402,23,20,25,20,88
2403,32,30,17,28,107
2404,29,32,18,27,106
2405,27,28,21,25,101
2406,19,31,16,23,89
2407,29,24,14,17,84
2408,21,27,20,26,94
2409,30,29,27,28,114
2410,26,28,15,27,96
2411,26,21,19,24,90
2412,28,39,23,19,109
2413,32,26,23,20,101
2414,35,27,28,22,112
2415,23,26,24,21,94
2416,24,30,20,19,93
2417,24,35,27,20,106
2418,19,29,21,20,89
2419,29,29,19,26,103
2420,23,33,30,18,104
2421,32,29,23,26,110
2422,29,23,22,22,96
2423,32,34,32,26,124
2424,29,31,21,22,103
2425,20,25,22,15,82
2426,22,39,30,22,113
2427,27,26,32,24,109
2428,23,22,19,26,90
2429,21,16,31,24,92
2430,32,26,24,19,101
2431,24,17,21,17,79
2432,39,21,24,23,107
2433,21,24,25,29,99
2434,21,28,28,25,102
2435,28,23,28,28,107
2436,19,26,28,20,93
2437,25,23,31,23,102
2438,25,24,29,26,104
2439,22,27,29,23,101
2440,21,23,18,17,79
2441,27,22,26,17,92
2442,19,38,28,27,112
2443,20,27,19,20,86
2444,33,31,21,21,106
2445,19,32,21,20,92
2446,31,22,25,27,105
2447,26,25,36,29,116
2448,30,23,21,18,92
2449,30,34,22,31,117
2450,27,37,11,25,100
2451,20,34,23,24,101
2452,28,29,18,24,99
2453,21,28,26,14,89
2454,26,30,16,17,89
2455,16,23,30,21,90
2456,24,34,19,23,100
2457,23,27,26,22,98
2458,22,28,25,31,106
2459,17,30,17,17,81
2460,14,33,22,17,86
2461,22,31,13,18,84
2462,25,24,26,17,92
2463,18,29,24,25,96
2464,27,23,25,27,102
2465,28,30,20,28,106
2466,20,21,25,17,83
2467,23,30,24,26,103
2468,21,31,23,19,94
2469,19,20,32,16,87
2470,23,21,27,22,93
2471,28,24,24,31,107
2472,29,26,28,24,107
2473,23,28,30,19,100
2474,21,36,17,22,96
2475,24,26,23,21,94
2476,27,23,14,23,87
2477,21,30,39,21,111
2478,25,27,24,29,105
2479,24,32,16,26,98
2480,23,22,25,37,107
2481,25,22,19,26,92
2482,39,31,21,21,112
2483,22,26,24,29,101
2484,19,22,33,25,99
2485,22,17,23,25,87
2486,29,27,23,32,111
2487,26,29,17,28,100
2488,28,17,27,21,93
2489,25,32,27,29,113
2490,24,25,25,28,102
2491,28,27,29,25,109
2492,27,31,30,30,118
2493,30,20,27,24,101
2494,11,17,16,21,65
2495,29,20,22,29,100
2496,28,22,21,20,91
2497,35,27,24,24,110
2498,28,31,22,29,110
2499,26,28,22,20,96
2500,34,35,27,26,122
2501,17,27,23,23,90
2502,24,25,17,29,95
2503,28,30,22,38,118
2504,25,34,26,28,113
2505,21,29,24,26,100
2506,27,18,20,21,86
2507,18,23,28,20,89
2508,25,16,26,20,87
2509,17,24,25,30,96
2510,22,37,26,35,120
2511,26,28,28,24,106
2512,27,24,26,28,105
2513,26,32,31,26,115
2514,22,23,16,28,89
2515,20,29,22,27,98
2516,27,25,15,22,89
2517,21,37,22,21,101
2518,23,15,25,18,81
2519,18,30,11,20,79
2520,23,25,25,18,91
2521,33,24,14,28,99
2522,23,31,21,24,99
2523,28,28,19,17,92
2524,27,16,17,24,84
2525,24,19,15,24,82
2526,24,25,11,28,88
2527,30,23,22,26,101
2528,33,39,32,26,130
2529,19,26,23,25,93
2530,21,22,26,24,93
2531,31,31,19,29,110
2532,31,25,26,21,103
2533,26,30,22,32,110
2534,25,39,21,32,117
2535,22,25,19,25,91
2536,29,33,30,42,134
2537,30,28,29,30,117
2538,28,27,21,25,101
2539,25,36,28,34,123
2540,24,27,23,16,90
2541,28,38,15,32,113
2542,21,39,22,30,112
2543,21,36,23,18,98
2544,32,22,27,23,104
2545,20,25,31,31,107
2546,24,33,26,23,106
2547,22,38,30,25,115
2548,25,30,31,23,109
2549,31,35,21,33,120
2550,18,24,21,25,88
2551,23,22,22,25,92
2552,30,31,23,24,108
2553,24,22,27,25,98
2554,27,21,22,32,102
2555,27,24,21,30,102
2556,18,30,18,24,90
2557,22,36,21,32,111
2558,22,21,20,11,74
2559,23,27,15,20,85
2560,27,30,24,23,104
2561,21,24,21,28,94
2562,31,27,33,24,115
2563,20,23,19,25,87
2564,24,29,28,17,98
2565,20,24,34,20,98
2566,22,17,22,20,81
2567,27,28,20,27,102
2568,25,16,30,14,85
2569,13,21,21,21,76
2570,30,32,17,24,103
2571,28,32,25,23,108
2572,34,25,17,32,108
2573,27,25,17,18,87
2574,29,25,25,25,104
2575,26,26,27,19,98
2576,27,27,16,16,86
2577,28,20,20,29,97
2578,18,27,28,21,94
2579,32,20,25,23,100
2580,27,36,23,20,106
2581,32,18,26,13,89
2582,18,24,28,17,87
2583,28,31,24,16,99
2584,28,22,22,20,92
2585,22,21,13,35,91
2586,23,23,26,25,97
2587,29,24,22,27,102
2588,16,24,30,18,88
2589,18,24,24,21,87
2590,16,23,20,35,94
2591,23,21,16,26,86
2592,19,30,25,29,103
2593,19,42,30,20,111
2594,19,31,23,32,105
2595,26,35,27,22,110
2596,20,26,26,26,98
2597,22,21,32,23,98
2598,29,26,17,16,88
2599,27,33,30,19,109
2600,22,28,31,24,105
2601,22,24,29,27,102
2602,31,28,29,24,112
2603,20,21,17,29,87
2604,32,29,23,15,99
2605,17,32,21,24,94
2606,20,23,29,22,94
2607,24,19,30,25,98
2608,25,20,18,21,84
2609,23,28,22,25,98
2610,27,25,25,22,99
2611,23,19,14,30,86
2612,33,24,31,26,114
2613,21,21,24,30,96
2614,29,27,24,24,104
2615,18,29,22,24,93
2616,18,29,17,19,83
2617,30,22,17,26,95
2618,26,32,24,21,103
2619,21,20,30,28,99
2620,25,28,22,26,101
2621,28,18,17,23,86
2622,30,28,23,30,111
2623,22,28,18,25,93
2624,30,21,19,33,103
2625,23,30,21,23,97
2626,32,31,18,21,102
2627,24,26,19,35,104
2628,25,28,17,37,107
2629,23,27,23,18,91
2630,24,25,17,33,99
2631,19,29,26,23,97
2632,20,26,20,23,89
2633,22,25,19,23,89
2634,25,28,36,33,122
2635,27,36,19,35,117
2636,31,32,27,26,116
2637,25,26,34,30,115
2638,27,26,24,37,114
2639,35,29,25,11,100
2640,37,25,33,21,116
2641,24,25,23,16,88
2642,22,33,22,29,106
2643,24,23,27,25,99
2644,24,27,22,31,104
2645,17,30,17,21,85
2646,21,30,25,21,97
2647,13,32,22,23,90
2648,28,20,33,24,105
2649,28,28,32,21,109
2650,18,21,24,23,86
2651,20,36,13,33,102
2652,25,27,22,31,105
2653,20,25,27,27,99
2654,22,24,16,29,91
2655,31,30,26,22,109
2656,15,17,20,16,68
2657,25,20,20,21,86
2658,26,21,28,20,95
2659,27,34,23,23,107
2660,25,26,28,20,99
2661,22,30,21,15,88
2662,20,23,29,25,97
2663,27,23,30,21,101
2664,16,29,24,24,93
2665,19,24,19,28,90
2666,22,25,25,19,91
2667,19,18,28,18,83
2668,27,24,29,26,106
2669,25,19,23,25,92
2670,20,24,27,29,100
2671,26,20,33,22,101
2672,20,32,27,28,107
2673,19,23,17,30,89
2674,14,24,23,28,89
2675,24,22,20,21,87
2676,23,30,21,22,96
2677,29,26,16,26,97
2678,29,25,25,25,104
2679,19,31,29,25,104
2680,23,27,19,35,104
2681,29,31,20,29,109
2682,15,38,19,31,103
2683,17,24,26,25,92
2684,24,23,25,16,88
2685,22,24,17,23,86
2686,27,24,22,16,89
2687,29,21,20,32,102
2688,24,29,28,28,109
2689,24,23,14,31,92
2690,30,23,29,21,103
2691,25,23,22,18,88
2692,30,24,26,27,107
2693,22,27,21,34,104
2694,26,34,16,21,97
2695,19,31,25,26,101
2696,21,24,29,20,94
2697,25,22,24,22,93
2698,17,29,24,26,96
2699,21,27,22,22,92
2700,18,33,24,16,91
2701,31,28,20,20,99
2702,24,20,22,23,89
2703,38,22,23,24,107
2704,33,33,27,23,116
2705,32,23,19,25,99
2706,18,35,24,42,119
2707,30,28,20,27,105
2708,28,31,27,16,102
2709,24,29,25,24,102
2710,26,26,25,23,100
2711,16,31,18,26,91
2712,26,31,31,31,119
2713,29,32,22,29,112
2714,17,28,19,23,87
2715,21,20,25,27,93
2716,22,25,25,17,89
2717,31,29,17,21,98
2718,31,28,21,25,105
2719,35,28,25,28,116
2720,21,20,29,16,86
2721,29,16,25,24,94
2722,27,28,21,27,103
2723,27,18,19,25,89
2724,36,29,28,29,122
2725,22,28,27,34,111
2726,21,34,24,25,104
2727,30,21,16,31,98
2728,32,21,31,27,111
2729,27,30,23,24,104
2730,14,25,23,20,82
2731,14,21,18,27,80
2732,23,25,22,21,91
2733,27,27,31,30,115
2734,25,34,33,26,118
2735,32,24,19,27,102
2736,23,28,20,24,95
2737,29,23,20,21,93
2738,14,29,22,25,90
2739,29,34,27,25,115
2740,20,25,21,22,88
2741,18,29,23,27,97
2742,18,30,21,28,97
2743,22,25,24,24,95
2744,19,32,27,28,106
2745,25,23,21,22,91
2746,23,25,27,29,104
2747,20,36,20,27,103
2748,23,23,30,19,95
2749,27,18,18,17,80
2750,27,23,18,19,87
2751,24,22,33,23,102
2752,23,25,23,19,90
2753,28,29,19,20,96
2754,29,25,19,26,99
2755,22,31,18,25,96
2756,23,29,18,27,97
2757,26,28,25,27,106
2758,29,28,24,25,106
2759,25,35,22,18,100
2760,23,24,18,21,86
2761,23,24,26,25,98
2762,28,33,21,27,109
2763,24,21,30,23,98
2764,19,30,23,22,94
2765,21,31,26,23,101
2766,22,25,26,22,95
2767,22,32,26,29,109
2768,29,18,22,31,100
2769,28,31,23,26,108
2770,41,32,22,28,123
2771,16,30,24,22,92
2772,28,34,25,16,103
2773,23,23,28,24,98
2774,24,30,28,30,112
2775,26,32,27,22,107
2776,24,26,24,23,97
2777,24,18,26,34,102
2778,27,25,22,22,96
2779,23,26,24,20,93
2780,33,27,27,28,115
2781,22,26,22,30,100
2782,31,31,19,20,101
2783,22,27,23,20,92
2784,19,29,27,22,97
2785,18,28,24,20,90
2786,22,33,29,21,105
2787,18,20,23,24,85
2788,26,31,27,21,105
2789,26,34,27,22,109
2790,36,22,28,33,119
2791,25,36,22,27,110
2792,26,23,25,26,100
2793,28,28,31,18,105
2794,24,30,21,31,106
2795,23,28,26,27,104
2796,18,25,28,32,103
2797,26,28,19,29,102
2798,23,32,17,27,99
2799,25,31,25,23,104
2800,22,28,24,19,93
2801,26,30,23,25,104
2802,27,23,22,34,106
2803,24,22,21,31,98
2804,27,25,24,25,101
2805,32,25,28,20,105
2806,25,29,24,24,102
2807,15,29,19,22,85
2808,27,24,20,34,105
2809,14,21,30,26,91
2810,23,32,25,30,110
2811,23,31,21,20,95
2812,30,31,19,33,113
2813,26,25,27,30,108
2814,25,24,19,23,91
2815,30,31,29,21,111
2816,25,15,25,25,90
2817,26,32,34,30,122
2818,25,24,24,24,97
2819,29,28,10,32,99
2820,27,33,16,28,104
2821,28,31,25,30,114
2822,19,32,18,19,88
2823,19,30,24,25,98
2824,25,28,21,25,99
2825,26,24,25,16,91
2826,18,26,20,31,95
2827,30,25,21,23,99
2828,18,24,24,31,97
2829,18,27,17,24,86
2830,25,29,28,26,108
2831,24,29,30,35,118
2832,18,25,19,25,87
2833,15,38,26,29,108
2834,27,36,26,22,111
2835,26,25,19,17,87
2836,22,27,30,30,109
2837,15,34,22,29,100
2838,29,29,24,19,101
2839,18,21,21,27,87
2840,34,30,23,27,114
2841,21,29,28,27,105
2842,20,31,20,27,98
2843,20,23,27,24,94
2844,30,28,24,37,119
2845,25,29,30,29,113
2846,33,26,25,24,108
2847,19,21,29,22,91
2848,30,25,28,31,114
2849,24,25,31,27,107
2850,25,36,26,28,115
2851,30,21,24,17,92
2852,23,25,23,28,99
2853,22,28,34,19,103
2854,22,25,21,26,94
2855,24,31,19,23,97
2856,28,26,24,29,107
2857,18,27,21,29,95
2858,20,35,24,24,103
2859,25,29,13,24,91
2860,23,27,30,26,106
2861,22,34,21,17,94
2862,14,29,21,27,91
2863,18,28,20,24,90
2864,20,23,25,29,97
2865,30,34,24,33,121
2866,25,25,25,24,99
2867,22,26,20,28,96
2868,24,23,30,33,110
2869,29,32,30,24,115
2870,30,19,17,27,93
2871,29,27,23,23,102
2872,20,24,25,16,85
2873,24,22,29,24,99
2874,19,28,30,23,100
2875,21,28,18,20,87
2876,27,34,25,27,113
2877,27,34,24,29,114
2878,22,23,23,26,94
2879,32,39,32,21,124
2880,24,14,29,24,91
2881,35,26,29,16,106
2882,28,31,24,31,114
2883,28,25,16,26,95
2884,25,27,30,23,105
2885,23,21,24,19,87
2886,29,32,16,24,101
2887,27,26,25,28,106
2888,28,23,27,21,99
2889,23,26,28,25,102
2890,24,34,25,22,105
2891,21,24,17,17,79
2892,22,19,12,19,72
2893,21,32,25,26,104
2894,28,29,24,16,97
2895,25,28,15,20,88
2896,26,32,26,23,107
2897,31,30,32,22,115
2898,15,25,24,26,90
2899,24,34,18,27,103
2900,24,30,23,18,95
2901,21,23,31,28,103
2902,25,28,19,16,88
2903,30,40,25,24,119
2904,25,29,28,21,103
2905,24,31,27,27,109
2906,28,42,22,21,113
2907,24,29,19,26,98
2908,24,36,21,18,99
2909,19,31,21,21,92
2910,24,32,19,18,93
2911,26,31,26,27,110
2912,24,23,26,21,94
2913,23,17,27,26,93
2914,35,28,24,15,102
2915,20,33,33,23,109
2916,30,29,12,24,95
2917,30,33,19,23,105
2918,32,25,15,26,98
2919,13,21,28,25,87
2920,19,25,20,29,93
2921,18,25,32,18,93
2922,23,24,29,23,99
2923,20,28,31,23,102
2924,22,20,29,20,91
2925,20,30,24,19,93
2926,23,26,30,29,108
2927,24,23,27,26,100
2928,20,24,30,33,107
2929,17,19,22,20,78
2930,26,19,16,27,88
2931,19,20,19,19,77
2932,32,30,27,22,111
2933,26,22,18,29,95
2934,22,23,21,29,95
2935,26,33,19,27,105
2936,27,34,24,19,104
2937,17,22,21,20,80
2938,18,30,23,24,95
2939,30,38,28,21,117
2940,22,23,20,19,84
2941,29,30,29,20,108
2942,16,26,23,23,88
2943,22,20,20,29,91
2944,24,40,26,33,123
2945,27,32,17,27,103
2946,30,29,27,25,111
2947,18,20,19,24,81
2948,27,27,18,23,95
2949,23,23,21,23,90
2950,25,28,24,23,100
2951,23,19,22,31,95
2952,20,23,21,24,88
2953,28,18,28,20,94
2954,17,30,24,23,94
2955,33,20,15,21,89
2956,22,28,25,17,92
2957,25,30,19,24,98
2958,26,27,15,25,93
2959,27,30,21,18,96
2960,30,30,34,20,114
2961,26,29,20,19,94
2962,20,28,29,27,104
2963,29,32,23,23,107
2964,21,30,20,21,92
2965,32,34,22,26,114
2966,27,29,19,20,95
2967,22,27,32,27,108
2968,20,24,30,19,93
2969,27,29,25,26,107
2970,15,22,21,22,80
2971,30,22,25,22,99
2972,28,29,25,25,107
2973,26,35,31,26,118
2974,20,28,19,21,88
2975,27,30,22,27,106
2976,25,27,28,29,109
2977,23,28,26,24,101
2978,21,30,27,23,101
2979,31,34,22,33,120
2980,29,25,29,29,112
2981,29,19,20,18,86
2982,30,30,29,21,110
2983,21,27,25,27,100
2984,35,30,25,24,114
2985,25,35,26,27,113
2986,20,36,23,18,97
2987,17,30,23,19,89
2988,31,30,22,20,103
2989,17,31,24,17,89
2990,15,33,26,19,93
2991,27,28,18,31,104
2992,17,19,27,37,100
2993,24,25,24,30,103
2994,21,31,23,17,92
2995,27,28,28,24,107
2996,22,32,25,31,110
2997,26,27,25,30,108
2998,17,26,27,30,100
2999,33,25,24,18,100
3000,13,23,23,25,84
3001,27,30,23,32,112
3002,23,31,27,25,106
3003,23,30,25,31,109
3004,26,21,21,18,86
3005,19,26,21,37,103
3006,27,28,22,28,105
3007,18,29,20,23,90
3008,28,35,21,20,104
3009,25,21,26,31,103
3010,30,34,21,22,107
3011,23,33,15,34,105
3012,13,24,28,30,95
3013,24,30,25,35,114
3014,27,23,27,28,105
3015,29,25,22,33,109
3016,32,24,17,29,102
3017,31,26,21,15,93
3018,26,32,18,32,108
3019,28,25,21,28,102
3020,22,24,22,23,91
3021,21,17,26,30,94
3022,21,26,21,29,97
3023,28,32,22,25,107
3024,22,27,22,31,102
3025,30,17,30,31,108
3026,22,29,26,23,100
3027,28,29,22,22,101
3028,29,32,28,32,121
3029,25,35,19,23,102
3030,26,33,18,20,97
3031,27,29,23,23,102
3032,23,34,26,25,108
3033,34,33,24,30,121
3034,39,35,21,21,116
3035,21,38,15,22,96
3036,17,31,26,37,111
3037,23,31,21,32,107
3038,30,34,18,24,106
3039,20,26,27,24,97
3040,18,37,29,27,111
3041,22,31,35,22,110
3042,25,27,30,24,106
3043,19,27,26,26,98
3044,25,38,19,30,112
3045,25,31,26,28,110
3046,21,25,27,27,100
3047,29,23,22,22,96
3048,31,26,25,21,103
3049,18,24,18,22,82
3050,22,28,13,32,95
3051,28,27,20,17,92
3052,15,30,20,24,89
3053,30,29,16,27,102
3054,23,34,16,19,92
3055,23,25,20,26,94
3056,27,33,18,19,97
3057,18,26,32,18,94
3058,22,25,31,20,98
3059,25,28,18,25,96
3060,39,32,18,25,114
3061,23,22,25,32,102
3062,26,24,20,20,90
3063,28,15,28,25,96
3064,20,22,17,17,76
3065,26,31,21,17,95
3066,28,26,14,34,102
3067,25,31,31,31,118
3068,24,37,28,16,105
3069,23,26,15,24,88
3070,24,33,21,23,101
3071,23,21,20,33,97
3072,25,28,27,26,106
3073,31,23,19,28,101
3074,30,31,19,20,100
3075,20,23,22,30,95
3076,26,23,25,27,101
3077,23,33,26,35,117
3078,17,26,20,27,90
3079,26,23,18,24,91
3080,25,29,24,25,103
3081,22,27,20,21,90
3082,31,28,23,20,102
3083,20,25,28,31,104
3084,19,35,23,23,100
3085,23,28,25,32,108
3086,26,28,20,20,94
3087,25,20,17,30,92
3088,21,39,19,23,102
3089,28,25,20,26,99
3090,20,32,29,24,105
3091,28,25,23,24,100
3092,27,31,26,24,108
3093,18,29,21,14,82
3094,22,26,28,24,100
3095,19,31,17,30,97
3096,22,33,23,23,101
3097,25,27,18,27,97
3098,26,24,28,25,103
3099,32,14,33,19,98
3100,35,30,28,24,117
3101,29,30,21,27,107
3102,29,24,26,35,114
3103,29,30,15,21,95
3104,25,37,22,16,100
3105,31,22,30,25,108
3106,20,22,20,17,79
3107,20,25,21,25,91
3108,29,30,31,21,111
3109,24,27,24,20,95
3110,26,26,21,20,93
3111,18,20,19,28,85
3112,24,30,23,18,95
3113,33,29,25,21,108
3114,26,23,19,20,88
3115,24,25,23,22,94
3116,24,24,23,17,88
3117,25,24,21,34,104
3118,17,29,21,30,97
3119,25,30,20,26,101
3120,37,23,22,26,108
3121,28,28,22,26,104
3122,13,22,21,25,81
3123,24,18,28,27,97
3124,26,28,31,19,104
3125,23,29,26,28,106
3126,33,25,19,27,104
3127,21,26,28,23,98
3128,22,31,20,23,96
3129,24,31,27,26,108
3130,26,27,25,23,101
3131,35,29,24,28,116
3132,25,39,28,25,117
3133,30,31,14,20,95
3134,33,31,21,28,113
3135,21,33,27,29,110
3136,25,22,19,12,78
3137,20,32,23,29,104
3138,21,30,19,15,85
3139,21,33,34,26,114
3140,27,31,30,20,108
3141,19,24,19,21,83
3142,20,22,19,24,85
3143,33,25,28,21,107
3144,30,37,28,27,122
3145,25,31,18,26,100
3146,28,21,28,21,98
3147,18,30,21,15,84
3148,32,27,16,29,104
3149,24,27,21,20,92
3150,24,30,18,24,96
3151,24,20,22,28,94
3152,24,33,30,26,113
3153,21,18,24,42,105
3154,31,23,27,20,101
3155,25,24,19,24,92
3156,27,28,28,23,106
3157,26,25,21,25,97
3158,31,30,29,21,111
3159,20,25,12,21,78
3160,24,34,27,30,115
3161,33,23,18,25,99
3162,19,32,24,24,99
3163,28,32,22,25,107
3164,19,27,14,30,90
3165,21,39,32,29,121
3166,12,22,26,25,85
3167,26,24,20,22,92
3168,26,35,19,23,103
3169,22,34,22,30,108
3170,29,34,18,21,102
3171,28,24,14,22,88
3172,17,38,32,21,108
3173,19,22,22,28,91
3174,25,36,24,24,109
3175,22,34,22,20,98
3176,22,38,22,21,103
3177,22,28,22,22,94
3178,26,29,22,26,103
3179,27,40,26,26,119
3180,23,35,26,20,104
3181,24,34,28,24,110
3182,27,35,32,21,115
3183,26,23,28,18,95
3184,28,28,29,17,102
3185,28,34,23,17,102
3186,24,31,22,25,102
3187,22,53,27,28,130
3188,30,27,27,29,113
3189,25,22,19,23,89
3190,23,17,24,26,90
3191,26,24,21,17,88
3192,14,29,24,25,92
3193,34,32,39,24,129
3194,21,28,25,20,94
3195,23,27,21,20,91
3196,19,24,32,17,92
3197,26,29,14,21,90
3198,31,29,33,23,116
3199,18,25,25,30,98
3200,25,28,28,23,104
3201,27,31,20,23,101
3202,24,26,28,25,103
3203,20,27,16,26,89
3204,14,29,24,26,93
3205,29,29,31,32,121
3206,32,24,22,20,98
3207,22,25,21,33,101
3208,24,32,26,33,115
3209,29,43,26,32,130
3210,23,31,30,31,115
3211,23,21,21,29,94
3212,24,30,26,23,103
3213,31,20,20,33,104
3214,18,21,27,28,94
3215,30,25,17,22,94
3216,24,31,31,29,115
3217,29,36,26,21,112
3218,19,28,22,19,88
3219,26,23,23,22,94
3220,19,25,26,16,86
3221,24,28,22,31,105
3222,18,24,24,27,93
3223,17,26,28,27,98
3224,24,28,24,21,97
3225,25,30,28,24,107
3226,23,24,21,24,92
3227,15,33,26,28,102
3228,32,28,21,15,96
3229,19,25,29,21,94
3230,26,29,27,26,108
3231,32,25,19,29,105
3232,22,32,17,18,89
3233,26,25,22,28,101
3234,22,29,22,36,109
3235,22,28,22,26,98
3236,20,16,22,19,77
3237,36,25,27,29,117
3238,20,25,33,23,101
3239,28,24,21,19,92
3240,28,25,18,20,91
3241,24,23,24,28,99
3242,27,28,30,28,113
3243,25,22,25,23,95
3244,24,28,27,22,101
3245,30,32,34,23,119
3246,25,35,24,19,103
3247,24,30,25,17,96
3248,30,31,25,24,110
3249,27,33,32,25,117
3250,21,26,23,22,92
3251,25,30,19,19,93
3252,26,32,24,20,102
3253,32,28,25,24,109
3254,22,31,12,27,92
3255,18,24,28,24,94
3256,23,21,20,23,87
3257,25,26,23,31,105
3258,25,25,29,23,102
3259,28,27,22,25,102
3260,19,25,17,34,95
3261,29,36,21,36,122
3262,20,20,15,23,78
3263,33,32,22,22,109
3264,14,26,20,19,79
3265,20,27,21,24,92
3266,30,20,21,28,99
3267,22,25,28,32,107
3268,35,35,22,16,108
3269,31,22,27,22,102
3270,25,26,20,16,87
3271,30,21,30,24,105
3272,28,20,29,16,93
3273,24,22,19,19,84
3274,28,22,23,31,104
3275,29,26,15,29,99
3276,21,19,29,21,90
3277,22,26,19,28,95
3278,24,27,26,19,96
3279,20,34,20,33,107
3280,24,28,23,30,105
3281,21,37,21,23,102
3282,20,26,25,21,92
3283,23,20,20,25,88
3284,26,23,27,22,98
3285,30,38,30,24,122
3286,28,32,22,31,113
3287,24,30,22,20,96
3288,20,24,27,27,98
3289,18,25,29,25,97
3290,26,28,26,24,104
3291,27,37,27,16,107
3292,22,26,26,15,89
3293,20,26,34,18,98
3294,19,30,22,37,108
3295,23,27,27,19,96
3296,22,29,20,18,89
3297,24,27,14,40,105
3298,21,19,20,26,86
3299,28,28,27,21,104
3300,27,36,34,23,120
3301,36,25,22,23,106
3302,16,27,21,20,84
3303,25,30,27,21,103
3304,23,30,24,20,97
3305,26,25,17,27,95
3306,26,28,25,14,93
3307,26,23,32,31,112
3308,21,28,15,21,85
3309,25,35,23,22,105
3310,23,24,27,28,102
3311,26,26,21,26,99
3312,22,25,24,16,87
3313,15,31,17,25,88
3314,25,35,26,33,119
3315,29,29,21,20,99
3316,23,26,19,30,98
3317,29,22,20,29,100
3318,32,17,18,20,87
3319,28,30,30,29,117
3320,28,18,26,23,95
3321,26,34,26,32,118
3322,34,21,29,26,110
3323,29,26,30,25,110
3324,26,22,15,27,90
3325,21,23,21,18,83
3326,27,29,22,19,97
3327,31,21,28,33,113
3328,30,30,25,21,106
3329,23,30,24,24,101
3330,29,30,31,21,111
3331,28,19,24,25,96
3332,39,29,27,22,117
3333,27,27,20,23,97
3334,25,30,19,22,96
3335,20,22,30,24,96
3336,23,23,24,33,103
3337,20,20,25,25,90
3338,29,29,20,26,104
3339,25,29,19,32,105
3340,31,27,29,31,118
3341,26,26,20,30,102
3342,24,28,27,34,113
3343,18,27,19,27,91
3344,24,26,31,19,100
3345,36,28,28,22,114
3346,27,26,14,33,100
3347,22,26,14,27,89
3348,22,28,22,30,102
3349,23,30,23,29,105
3350,21,28,20,23,92
3351,26,29,22,30,107
3352,17,21,23,24,85
3353,21,34,28,26,109
3354,30,29,27,32,118
3355,26,38,14,28,106
3356,19,29,29,26,103
3357,29,31,24,21,105
3358,24,39,26,27,116
3359,19,23,21,24,87
3360,22,27,30,27,106
3361,26,17,33,24,100
3362,29,29,25,26,109
3363,27,29,29,18,103
3364,26,26,33,17,102
3365,26,28,17,20,91
3366,20,24,18,23,85
3367,27,30,22,17,96
3368,19,23,25,28,95
3369,26,30,17,23,96
3370,23,34,25,21,103
3371,23,24,35,20,102
3372,27,37,27,34,125
3373,21,29,29,24,103
3374,21,22,27,27,97
3375,31,37,33,30,131
3376,17,24,26,17,84
3377,26,38,28,25,117
3378,23,20,15,23,81
3379,20,34,20,19,93
3380,26,26,25,27,104
3381,24,26,26,21,97
3382,28,20,27,29,104
3383,24,40,26,35,125
3384,19,34,28,23,104
3385,29,32,28,33,122
3386,26,32,16,25,99
3387,26,17,26,17,86
3388,28,29,28,28,113
3389,29,30,27,26,112
3390,20,31,25,30,106
3391,20,30,22,33,105
3392,15,35,23,18,91
3393,28,29,11,18,86
3394,26,27,26,30,109
3395,20,28,25,17,90
3396,16,33,17,28,94
3397,27,34,29,26,116
3398,20,28,23,21,92
3399,28,29,20,25,102
3400,25,19,17,15,76
3401,20,29,30,20,99
3402,32,18,22,23,95
3403,30,26,14,21,91
3404,25,24,30,27,106
3405,30,26,20,19,95
3406,32,31,15,17,95
3407,27,18,25,30,100
3408,19,27,25,24,95
3409,23,27,21,17,88
3410,23,25,24,19,91
3411,26,19,19,20,84
3412,22,20,30,23,95
3413,30,20,15,17,82
3414,22,26,25,23,96
3415,16,36,15,30,97
3416,10,32,22,25,89
3417,21,29,27,23,100
3418,20,27,27,29,103
3419,25,28,20,18,91
3420,26,26,28,21,101
3421,37,33,21,23,114
3422,25,27,21,20,93
3423,34,29,22,25,110
3424,24,29,28,19,100
3425,25,22,24,22,93
3426,30,31,19,20,100
3427,28,32,18,28,106
3428,20,32,24,21,97
3429,19,25,17,23,84
3430,25,22,18,26,91
3431,17,18,15,24,74
3432,31,22,23,27,103
3433,20,26,20,22,88
3434,26,27,23,25,101
3435,32,25,17,31,105
3436,24,31,27,16,98
3437,26,30,21,22,99
3438,26,37,16,23,102
3439,26,23,20,26,95
3440,22,29,31,19,101
3441,22,30,25,29,106
3442,23,22,27,24,96
3443,32,28,21,22,103
3444,21,39,23,19,102
3445,24,34,21,26,105
3446,23,32,28,33,116
3447,33,25,15,25,98
3448,32,21,25,22,100
3449,22,34,26,25,107
3450,24,26,29,34,113
3451,20,35,22,16,93
3452,27,28,23,23,101
3453,27,27,36,27,117
3454,19,26,20,29,94
3455,21,32,31,24,108
3456,21,27,23,20,91
3457,26,33,19,24,102
3458,18,34,21,20,93
3459,24,25,27,20,96
3460,34,33,27,26,120
3461,21,29,31,32,113
3462,24,23,23,27,97
3463,33,28,18,28,107
3464,25,29,18,21,93
3465,24,27,26,25,102
3466,22,27,32,19,100
3467,15,19,27,27,88
3468,21,20,20,15,76
3469,29,31,25,25,110
3470,19,31,28,22,100
3471,23,22,21,28,94
3472,19,39,22,28,108
3473,23,32,19,25,99
3474,26,23,28,26,103
3475,32,36,24,28,120
3476,25,27,32,16,100
3477,21,29,32,29,111
3478,15,30,25,24,94
3479,16,30,25,21,92
3480,23,25,28,25,101
3481,29,36,29,25,119
3482,23,27,16,26,92
3483,20,26,16,20,82
3484,16,22,27,34,99
3485,18,28,22,27,95
3486,16,34,26,30,106
3487,23,33,26,21,103
3488,28,27,32,30,117
3489,22,28,22,20,92
3490,20,34,30,31,115
3491,29,40,26,28,123
3492,22,33,21,21,97
3493,25,17,28,32,102
3494,28,36,16,24,104
3495,17,31,20,24,92
3496,14,25,21,25,85
3497,14,21,22,26,83
3498,21,27,18,24,90
3499,26,31,20,26,103
3500,19,27,30,25,101
3501,26,23,20,22,91
3502,24,28,18,22,92
3503,21,22,18,14,75
3504,29,34,15,24,102
3505,22,24,19,24,89
3506,24,23,27,22,96
3507,29,38,26,22,115
3508,20,38,28,19,105
3509,23,28,25,21,97
3510,24,17,14,25,80
3511,21,34,21,24,100
3512,21,27,25,25,98
3513,19,23,21,18,81
3514,18,31,14,22,85
3515,19,27,20,29,95
3516,24,22,24,29,99
3517,26,17,20,24,87
3518,23,26,25,20,94
3519,22,26,23,23,94
3520,27,31,14,24,96
3521,20,26,22,30,98
3522,31,29,20,43,123
3523,18,27,17,31,93
3524,26,22,22,23,93
3525,23,30,30,24,107
3526,28,30,23,26,107
3527,30,19,18,27,94
3528,24,25,23,23,95
3529,28,27,12,27,94
3530,17,32,22,30,101
3531,25,29,26,15,95
3532,16,26,27,28,97
3533,22,32,34,22,110
3534,25,30,21,27,103
3535,21,26,23,24,94
3536,25,21,19,27,92
3537,37,30,31,28,126
3538,21,26,28,28,103
3539,31,22,29,15,97
3540,27,33,19,19,98
3541,25,27,22,28,102
3542,23,25,30,26,104
3543,26,32,22,24,104
3544,20,19,25,24,88
3545,24,26,18,22,90
3546,18,28,27,24,97
3547,26,28,16,19,89
3548,27,27,24,22,100
3549,19,26,22,18,85
3550,31,20,18,30,99
3551,21,30,18,26,95
3552,26,25,24,21,96
3553,28,30,26,23,107
3554,20,22,28,21,91
3555,19,33,22,22,96
3556,24,36,35,22,117
3557,29,27,26,22,104
3558,22,32,24,32,110
3559,29,25,23,32,109
3560,27,34,27,24,112
3561,18,24,30,17,89
3562,25,25,23,28,101
3563,21,24,24,17,86
3564,21,23,21,19,84
3565,20,33,28,31,112
3566,28,26,21,28,103
3567,23,21,25,19,88
3568,23,36,26,24,109
3569,21,26,18,23,88
3570,26,29,32,22,109
3571,23,25,18,21,87
3572,24,27,21,22,94
3573,20,21,29,24,94
3574,23,27,23,15,88
3575,32,20,35,26,113
3576,35,28,20,29,112
3577,19,26,21,26,92
3578,33,26,21,23,103
3579,24,16,19,16,75
3580,26,26,22,21,95
3581,26,22,26,30,104
3582,12,21,27,19,79
3583,15,29,32,21,97
3584,28,34,27,22,111
3585,23,32,20,23,98
3586,27,36,19,16,98
3587,28,29,26,28,111
3588,29,24,16,28,97
3589,23,30,29,26,108
3590,23,21,18,31,93
3591,32,31,23,33,119
3592,24,36,22,32,114
3593,23,27,21,23,94
3594,28,27,29,29,113
3595,23,27,27,19,96
3596,19,27,27,17,90
3597,31,25,22,26,104
3598,19,25,16,20,80
3599,21,27,14,28,90
3600,19,26,16,15,76
3601,23,21,35,18,97
3602,22,22,22,25,91
3603,27,24,28,13,92
3604,21,24,17,25,87
3605,19,29,27,17,92
3606,23,33,21,26,103
3607,27,19,18,22,86
3608,21,16,37,24,98
3609,17,26,19,28,90
3610,23,27,25,22,97
3611,23,25,26,27,101
3612,27,19,27,17,90
3613,28,31,20,29,108
3614,18,24,27,17,86
3615,21,26,25,32,104
3616,32,25,28,33,118
3617,26,30,22,19,97
3618,34,26,26,26,112
3619,32,26,30,28,116
3620,27,26,29,25,107
3621,30,30,20,17,97
3622,15,29,17,24,85
3623,29,26,24,40,119
3624,21,20,10,24,75
3625,18,28,22,21,89
3626,21,28,27,20,96
3627,17,23,17,29,86
3628,25,30,29,29,113
3629,27,32,22,27,108
3630,22,31,19,20,92
3631,23,27,25,20,95
3632,18,35,20,21,94
3633,25,33,22,29,109
3634,24,30,20,23,97
3635,19,23,28,25,95
3636,28,28,27,23,106
3637,17,20,20,27,84
3638,26,24,19,26,95
3639,21,24,17,21,83
3640,24,34,17,24,99
3641,31,31,19,25,106
3642,16,24,21,25,86
3643,25,28,28,24,105
3644,18,34,15,21,88
3645,16,34,27,30,107
3646,33,28,20,23,104
3647,17,24,30,27,98
3648,23,21,26,23,93
3649,29,33,24,39,125
3650,23,31,33,22,109
3651,25,21,20,27,93
3652,24,31,25,29,109
3653,26,24,21,23,94
3654,33,37,21,26,117
3655,29,28,21,27,105
3656,18,28,26,24,96
3657,33,20,16,36,105
3658,22,27,18,24,91
3659,20,29,18,21,88
3660,18,23,27,27,95
3661,23,30,28,21,102
3662,24,36,24,18,102
3663,36,32,20,19,107
3664,21,37,20,23,101
3665,22,27,24,24,97
3666,27,23,23,20,93
3667,34,27,26,23,110
3668,17,27,25,23,92
3669,23,32,19,23,97
3670,25,23,18,18,84
3671,25,23,19,23,90
3672,17,32,21,27,97
3673,19,23,22,20,84
3674,18,27,17,25,87
3675,24,27,28,21,100
3676,25,29,21,34,109
3677,22,24,23,21,90
3678,25,21,12,22,80
3679,17,34,43,25,119
3680,25,28,27,24,104
3681,26,26,28,28,108
3682,25,31,31,30,117
3683,12,25,30,19,86
3684,25,26,40,26,117
3685,35,28,22,22,107
3686,27,22,15,20,84
3687,28,38,35,24,125
3688,19,34,24,32,109
3689,27,24,27,30,108
3690,26,27,17,22,92
3691,22,23,27,33,105
3692,30,27,23,27,107
3693,26,30,20,26,102
3694,25,25,21,25,96
3695,26,29,28,22,105
3696,18,29,21,24,92
3697,29,29,19,25,102
3698,20,27,23,34,104
3699,33,21,18,16,88
3700,21,28,18,29,96
3701,19,32,21,22,94
3702,25,20,28,30,103
3703,24,32,22,26,104
3704,24,29,23,20,96
3705,25,28,23,28,104
3706,27,28,18,20,93
3707,25,27,28,30,110
3708,21,21,18,22,82
3709,29,22,21,28,100
3710,20,31,19,23,93
3711,25,24,27,20,96
3712,19,29,27,23,98
3713,19,27,21,25,92
3714,24,26,33,24,107
3715,21,25,25,31,102
3716,13,26,27,32,98
3717,24,30,21,27,102
3718,27,33,28,27,115
3719,31,22,26,22,101
3720,19,40,17,21,97
3721,26,23,27,21,97
3722,23,25,27,23,98
3723,26,33,29,29,117
3724,17,24,30,28,99
3725,30,25,30,25,110
3726,30,26,21,25,102
3727,18,30,21,26,95
3728,32,23,27,19,101
3729,29,25,34,24,112
3730,22,30,29,30,111
3731,26,31,23,26,106
3732,28,35,20,19,102
3733,35,22,24,30,111
3734,21,22,11,12,66
3735,16,30,16,30,92
3736,20,30,22,27,99
3737,31,24,31,30,116
3738,23,22,18,29,92
3739,19,27,35,29,110
3740,25,23,25,19,92
3741,31,25,24,25,105
3742,22,26,32,31,111
3743,14,26,22,21,83
3744,26,29,19,21,95
3745,22,25,27,21,95
3746,22,27,24,25,98
3747,18,34,27,25,104
3748,25,20,16,27,88
3749,31,22,24,22,99
3750,30,27,17,22,96
3751,21,25,18,25,89
3752,24,31,19,24,98
3753,30,29,20,29,108
3754,29,24,25,26,104
3755,19,32,33,25,109
3756,22,21,26,23,92
3757,29,32,25,26,112
3758,22,27,25,27,101
3759,35,28,20,33,116
3760,19,35,24,18,96
3761,23,28,30,34,115
3762,27,29,18,25,99
3763,27,41,23,33,124
3764,30,22,23,31,106
3765,26,31,21,20,98
3766,25,18,27,27,97
3767,30,20,20,23,93
3768,22,24,30,25,101
3769,26,39,19,27,111
3770,16,32,22,28,98
3771,24,39,27,33,123
3772,26,33,17,20,96
3773,28,22,21,28,99
3774,27,33,23,21,104
3775,25,26,24,22,97
3776,27,34,24,30,115
3777,32,24,21,22,99
3778,21,30,19,16,86
3779,29,22,22,24,97
3780,25,27,31,17,100
3781,19,33,24,21,97
3782,26,31,20,30,107
3783,23,36,26,24,109
3784,24,35,18,18,95
3785,29,20,21,20,90
3786,16,30,23,19,88
3787,21,32,23,22,98
3788,21,28,28,28,105
3789,29,32,35,24,120
3790,23,28,20,24,95
3791,26,30,24,23,103
3792,23,36,21,14,94
3793,27,26,33,35,121
3794,16,27,25,19,87
3795,20,25,18,21,84
3796,24,26,24,17,91
3797,17,25,22,18,82
3798,26,25,22,27,100
3799,26,23,25,32,106
3800,27,31,31,29,118
3801,22,18,30,18,88
3802,26,24,27,16,93
3803,27,28,25,23,103
3804,27,27,18,22,94
3805,17,21,20,27,85
3806,32,30,29,28,119
3807,24,31,29,27,111
3808,20,25,17,21,83
3809,23,31,21,28,103
3810,33,24,24,32,113
3811,37,31,24,26,118
3812,28,28,22,32,110
3813,25,28,31,29,113
3814,24,20,29,25,98
3815,15,38,17,26,96
3816,18,18,26,15,77
3817,31,29,19,24,103
3818,12,20,18,20,70
3819,20,23,23,23,89
3820,25,24,26,25,100
3821,29,31,18,15,93
3822,22,31,30,17,100
3823,22,23,25,18,88
3824,33,27,28,31,119
3825,30,37,26,29,122
3826,24,30,31,40,125
3827,23,27,30,33,113
3828,25,26,22,20,93
3829,28,33,14,26,101
3830,23,21,27,26,97
3831,23,25,24,28,100
3832,13,23,18,22,76
3833,24,31,26,33,114
3834,36,29,23,26,114
3835,35,23,24,24,106
3836,17,35,26,21,99
3837,25,18,23,28,94
3838,20,24,23,28,95
3839,22,22,27,22,93
3840,27,28,30,27,112
3841,23,29,32,27,111
3842,22,32,21,13,88
3843,23,33,28,22,106
3844,23,24,29,31,107
3845,28,30,18,21,97
3846,28,22,25,22,97
3847,25,34,19,16,94
3848,33,28,23,19,103
3849,22,22,23,19,86
3850,19,20,25,33,97
3851,21,25,19,27,92
3852,22,31,31,25,109
3853,32,25,24,19,100
3854,20,27,29,28,104
3855,15,31,26,15,87
3856,28,29,30,22,109
3857,37,27,24,24,112
3858,21,27,14,27,89
3859,25,21,23,20,89
3860,34,24,27,23,108
3861,26,37,27,28,118
3862,21,24,28,20,93
3863,20,29,27,34,110
3864,34,30,24,32,120
3865,24,33,20,23,100
3866,15,26,22,18,81
3867,30,22,18,28,98
3868,28,24,21,26,99
3869,19,17,21,18,75
3870,23,28,32,27,110
3871,26,27,13,22,88
3872,27,23,17,16,83
3873,24,28,22,22,96
3874,19,21,19,19,78
3875,32,27,27,29,115
3876,17,35,18,15,85
3877,22,30,29,23,104
3878,24,30,14,25,93
3879,32,28,28,28,116
3880,26,31,16,19,92
3881,22,32,19,29,102
3882,19,26,31,28,104
3883,26,26,21,27,100
3884,19,23,33,24,99
3885,23,23,31,32,109
3886,29,24,24,25,102
3887,31,26,21,32,110
3888,29,25,27,31,112
3889,22,30,23,19,94
3890,26,20,22,24,92
3891,29,22,29,17,97
3892,21,40,26,21,108
3893,20,27,28,20,95
3894,30,27,26,25,108
3895,22,30,26,25,103
3896,25,33,23,28,109
3897,29,29,24,25,107
3898,24,27,28,19,98
3899,27,24,18,27,96
3900,27,37,23,26,113
3901,20,22,24,36,102
3902,26,23,26,26,101
3903,18,26,36,19,99
3904,22,25,26,31,104
3905,24,31,24,30,109
3906,28,26,23,19,96
3907,16,22,21,23,82
3908,27,28,30,31,116
3909,16,30,23,22,91
3910,25,23,28,25,101
3911,28,23,22,26,99
3912,19,38,29,24,110
3913,28,33,23,17,101
3914,25,24,31,25,105
3915,27,22,14,21,84
3916,18,26,16,22,82
3917,27,24,29,23,103
3918,22,26,29,25,102
3919,32,23,15,19,89
3920,18,31,23,17,89
3921,23,30,27,24,104
3922,21,27,25,23,96
3923,17,33,21,23,94
3924,12,34,25,30,101
3925,23,27,28,29,107
3926,28,26,28,19,101
3927,28,37,27,19,111
3928,28,23,18,22,91
3929,26,24,18,24,92
3930,26,27,28,23,104
3931,15,24,21,24,84
3932,19,34,24,24,101
3933,19,22,23,21,85
3934,16,28,24,28,96
3935,27,28,18,21,94
3936,21,31,26,27,105
3937,19,28,18,26,91
3938,29,26,23,22,100
3939,30,23,14,22,89
3940,20,31,22,26,99
3941,26,27,25,26,104
3942,21,30,21,29,101
3943,15,26,33,15,89
3944,27,28,27,24,106
3945,24,30,24,28,106
3946,25,22,26,20,93
3947,29,28,22,24,103
3948,16,22,24,28,90
3949,24,25,17,20,86
3950,22,30,21,18,91
3951,25,22,21,21,89
3952,32,29,20,24,105
3953,27,36,28,23,114
3954,28,20,21,23,92
3955,21,26,31,22,100
3956,25,18,30,25,98
3957,28,26,20,22,96
3958,17,22,29,21,89
3959,20,24,35,29,108
3960,20,24,22,24,90
3961,17,22,20,27,86
3962,22,26,16,30,94
3963,28,25,27,31,111
3964,21,26,23,16,86
3965,32,33,26,26,117
3966,21,25,27,18,91
3967,18,29,28,16,91
3968,28,23,24,25,100
3969,24,22,29,26,101
3970,25,28,24,28,105
3971,19,34,22,23,98
3972,26,29,20,25,100
3973,27,33,21,24,105
3974,37,35,20,31,123
3975,20,30,24,28,102
3976,18,28,21,19,86
3977,27,25,22,20,94
3978,23,23,34,22,102
3979,20,29,31,30,110
3980,30,28,18,26,102
3981,23,29,22,23,97
3982,21,32,22,21,96
3983,27,28,24,25,104
3984,21,24,28,29,102
3985,26,24,27,19,96
3986,32,30,27,28,117
3987,26,24,21,24,95
3988,31,26,27,19,103
3989,25,29,26,21,101
3990,35,28,23,21,107
3991,24,22,27,25,98
3992,33,35,29,28,125
3993,28,25,20,16,89
3994,26,23,19,18,86
3995,23,22,22,22,89
3996,27,27,23,22,99
3997,25,20,24,33,102
3998,25,32,22,28,107
3999,24,27,31,30,112
4000,20,32,24,27,103
4001,19,29,24,32,104
4002,27,28,29,20,104
4003,28,20,21,23,92
4004,22,37,30,22,111
4005,12,27,18,19,76
4006,18,29,25,23,95
4007,30,24,20,36,110
4008,38,30,26,17,111
4009,28,32,31,20,111
4010,25,20,20,22,87
4011,22,30,28,28,108
4012,15,34,27,26,102
4013,33,31,14,29,107
4014,26,33,28,24,111
4015,18,22,12,22,74
4016,33,25,19,15,92
4017,28,37,25,27,117
4018,23,32,25,25,105
4019,16,26,18,22,82
4020,23,26,28,31,108
4021,25,29,29,17,100
4022,23,20,19,26,88
4023,25,32,33,28,118
4024,28,23,23,23,97
4025,21,27,25,22,95
4026,24,23,24,22,93
4027,24,33,27,36,120
4028,22,35,27,24,108
4029,25,32,24,25,106
4030,20,32,26,31,109
4031,19,38,27,26,110
4032,27,23,24,25,99
4033,20,20,32,21,93
4034,27,23,20,14,84
4035,27,27,29,23,106
4036,29,23,29,20,101
4037,31,26,19,21,97
4038,24,24,31,25,104
4039,29,30,19,23,101
4040,26,26,26,28,106
4041,14,20,24,27,85
4042,19,25,26,19,89
4043,22,31,30,26,109
4044,31,21,23,26,101
4045,23,24,25,21,93
4046,20,22,14,21,77
4047,27,28,25,24,104
4048,34,16,19,27,96
4049,22,31,22,27,102
4050,23,25,34,22,104
4051,19,27,21,20,87
4052,15,28,10,35,88
4053,18,28,20,22,88
4054,19,28,24,28,99
4055,28,30,31,15,104
4056,25,32,21,19,97
4057,20,32,24,12,88
4058,27,26,28,28,109
4059,33,31,28,24,116
4060,21,27,17,24,89
4061,35,31,32,14,112
4062,29,29,21,21,100
4063,18,26,22,20,86
4064,20,29,25,27,101
4065,33,27,20,32,112
4066,36,36,29,24,125
4067,17,24,23,23,87
4068,16,28,22,34,100
4069,18,22,28,21,89
4070,20,30,19,27,96
4071,23,21,26,23,93
4072,23,36,25,18,102
4073,16,22,22,25,85
4074,21,27,18,21,87
4075,27,38,21,34,120
4076,22,33,24,28,107
4077,30,20,23,26,99
4078,26,34,16,24,100
4079,20,30,22,32,104
4080,33,32,18,21,104
4081,24,23,22,30,99
4082,21,33,22,26,102
4083,27,32,29,20,108
4084,21,14,18,21,74
4085,23,30,27,26,106
4086,23,19,29,20,91
4087,27,27,14,28,96
4088,20,23,20,30,93
4089,25,27,21,26,99
4090,26,24,28,17,95
4091,21,25,27,22,95
4092,23,31,15,20,89
4093,20,20,24,24,88
4094,22,22,15,26,85
4095,22,23,18,18,81
4096,23,22,20,26,91
4097,33,25,30,25,113
4098,29,33,30,22,114
4099,24,29,20,22,95
4100,26,22,18,21,87
4101,20,25,18,26,89
4102,19,35,23,27,104
4103,25,25,23,28,101
4104,25,27,22,25,99
4105,27,21,14,22,84
4106,27,31,32,24,114
4107,22,22,20,19,83
4108,25,27,26,34,112
4109,18,36,22,13,89
4110,24,34,30,25,113
4111,21,25,25,26,97
4112,19,22,22,16,79
4113,20,21,22,28,91
4114,20,24,26,25,95
4115,24,21,20,26,91
4116,16,32,24,22,94
4117,25,29,22,24,100
4118,36,27,18,31,112
4119,20,29,22,27,98
4120,20,20,10,25,75
4121,21,28,28,25,102
4122,38,34,28,27,127
4123,19,23,18,20,80
4124,29,25,27,29,110
4125,28,23,24,25,100
4126,20,26,22,22,90
4127,33,24,26,28,111
4128,31,32,22,27,112
4129,31,29,18,23,101
4130,31,31,26,26,114
4131,23,32,23,25,103
4132,26,36,33,25,120
4133,30,25,30,25,110
4134,16,27,17,21,81
4135,19,21,27,24,91
4136,26,28,23,25,102
4137,27,23,19,22,91
4138,21,19,17,22,79
4139,28,28,29,28,113
4140,37,32,17,28,114
4141,20,23,25,23,91
4142,21,31,25,25,102
4143,27,23,26,20,96
4144,24,27,34,24,109
4145,26,34,21,18,99
4146,22,30,29,29,110
4147,24,32,15,23,94
4148,34,36,26,35,131
4149,23,28,22,27,100
4150,30,26,21,32,109
4151,23,30,25,24,102
4152,26,36,18,24,104
4153,29,33,21,22,105
4154,23,29,25,21,98
4155,27,22,21,18,88
4156,30,27,23,29,109
4157,33,34,29,25,121
4158,21,29,31,25,106
4159,21,28,27,23,99
4160,27,33,22,21,103
4161,23,32,19,17,91
4162,19,21,14,39,93
4163,26,33,31,29,119
4164,23,27,16,25,91
4165,18,30,27,19,94
4166,26,23,19,22,90
4167,28,27,19,22,96
4168,29,24,28,23,104
4169,16,27,29,30,102
4170,20,22,26,24,92
4171,22,32,26,28,108
4172,23,28,24,27,102
4173,32,34,20,23,109
4174,21,26,23,28,98
4175,36,22,25,21,104
4176,19,25,20,21,85
4177,31,21,22,31,105
4178,24,20,27,22,93
4179,21,30,23,26,100
4180,25,24,26,18,93
4181,19,29,13,20,81
4182,23,25,22,23,93
4183,19,31,27,27,104
4184,27,27,18,17,89
4185,25,29,26,31,111
4186,39,26,35,23,123
4187,23,25,26,38,112
4188,17,27,19,24,87
4189,23,29,27,23,102
4190,27,31,23,21,102
4191,31,28,26,31,116
4192,21,33,28,21,103
4193,32,22,13,16,83
4194,22,25,24,25,96
4195,21,34,26,18,99
4196,24,26,22,31,103
4197,25,23,17,22,87
4198,26,32,25,32,115
4199,19,28,26,28,101
4200,22,29,32,23,106
4201,18,26,31,26,101
4202,21,22,26,23,92
4203,32,25,29,18,104
4204,23,30,36,18,107
4205,22,27,23,23,95
4206,23,36,23,20,102
4207,27,30,29,20,106
4208,21,36,29,28,114
4209,21,22,21,23,87
4210,27,22,29,27,105
4211,26,35,25,27,113
4212,21,33,30,22,106
4213,17,26,14,15,72
4214,21,28,26,26,101
4215,26,22,31,20,99
4216,26,21,18,26,91
4217,28,27,21,26,102
4218,26,24,24,30,104
4219,26,19,25,9,79
4220,23,22,18,19,82
4221,26,25,22,20,93
4222,25,23,23,29,100
4223,31,23,15,27,96
4224,23,22,28,30,103
4225,24,32,23,25,104
4226,35,26,21,25,107
4227,13,30,22,28,93
4228,31,21,26,28,106
4229,18,36,25,26,105
4230,23,25,23,20,91
4231,13,23,16,22,74
4232,24,32,23,29,108
4233,22,31,17,33,103
4234,23,28,28,25,104
4235,28,24,24,25,101
4236,27,38,23,22,110
4237,26,23,28,33,110
4238,23,26,23,24,96
4239,30,24,22,27,103
4240,30,25,25,23,103
4241,22,26,19,22,89
4242,16,31,17,24,88
4243,20,31,18,26,95
4244,29,27,19,29,104
4245,26,30,17,27,100
4246,21,27,25,20,93
4247,18,29,31,27,105
4248,33,27,23,23,106
4249,29,28,23,16,96
4250,23,27,19,22,91
4251,31,25,26,20,102
4252,22,25,24,28,99
4253,19,22,17,31,89
4254,30,31,30,30,121
4255,28,28,27,24,107
4256,18,31,29,17,95
4257,35,23,25,29,112
4258,20,19,31,25,95
4259,17,33,21,27,98
4260,35,25,27,25,112
4261,21,23,33,34,111
4262,32,25,21,21,99
4263,20,18,21,23,82
4264,28,21,23,23,95
4265,31,27,17,19,94
4266,21,28,23,34,106
4267,29,22,18,27,96
4268,24,25,26,20,95
4269,23,27,27,27,104
4270,30,30,15,21,96
4271,25,27,27,31,110
4272,23,28,21,22,94
4273,28,27,20,28,103
4274,29,21,23,30,103
4275,22,30,29,22,103
4276,22,26,26,26,100
4277,24,32,17,26,99
4278,20,27,28,17,92
4279,18,41,21,16,96
4280,24,20,18,25,87
4281,29,24,21,19,93
4282,21,28,20,23,92
4283,26,30,25,28,109
4284,30,30,34,19,113
4285,23,31,23,31,108
4286,27,24,16,22,89
4287,27,23,20,31,101
4288,22,30,19,16,87
4289,30,26,21,22,99
4290,25,28,25,26,104
4291,23,22,17,23,85
4292,27,35,30,23,115
4293,21,28,22,14,85
4294,28,26,30,29,113
4295,21,22,26,25,94
4296,24,26,20,19,89
4297,28,32,27,20,107
4298,29,33,27,23,112
4299,27,28,19,31,105
4300,24,24,18,25,91
4301,29,30,14,29,102
4302,21,26,19,25,91
4303,17,34,19,27,97
4304,22,31,28,24,105
4305,21,25,21,19,86
4306,24,22,23,18,87
4307,22,28,17,16,83
4308,31,25,22,20,98
4309,29,24,18,31,102
4310,18,25,13,12,68
4311,29,23,17,21,90
4312,32,29,27,29,117
4313,28,22,28,20,98
4314,34,24,26,24,108
4315,31,32,23,28,114
4316,31,27,22,16,96
4317,33,29,28,26,116
4318,16,32,20,23,91
4319,27,34,24,21,106
4320,16,32,29,24,101
4321,33,30,29,30,122
4322,18,22,27,24,91
4323,33,31,28,20,112
4324,20,28,33,19,100
4325,27,28,20,22,97
4326,28,26,26,21,101
4327,20,26,13,19,78
4328,25,25,22,21,93
4329,27,24,31,19,101
4330,28,25,21,26,100
4331,23,25,24,19,91
4332,36,31,26,19,112
4333,29,26,26,24,105
4334,19,27,23,18,87
4335,26,29,22,25,102
4336,23,21,27,25,96
4337,25,29,23,24,101
4338,16,33,21,21,91
4339,25,29,25,32,111
4340,24,27,28,28,107
4341,25,37,25,24,111
4342,24,28,17,25,94
4343,22,27,27,30,106
4344,28,26,29,26,109
4345,21,31,20,24,96
4346,17,23,25,29,94
4347,20,32,22,22,96
4348,22,38,23,18,101
4349,18,26,26,28,98
4350,26,20,28,28,102
4351,30,23,19,19,91
4352,22,30,29,27,108
4353,21,30,20,26,97
4354,24,30,17,26,97
4355,22,20,26,30,98
4356,19,24,23,28,94
4357,23,20,19,18,80
4358,26,38,17,29,110
4359,28,25,18,22,93
4360,18,29,21,27,95
4361,29,24,30,24,107
4362,35,25,37,23,120
4363,26,30,32,30,118
4364,24,39,25,31,119
4365,18,19,16,18,71
4366,28,29,27,26,110
4367,30,25,25,23,103
4368,24,39,24,23,110
4369,28,26,17,34,105
4370,27,22,17,27,93
4371,29,29,23,29,110
4372,30,23,23,33,109
4373,25,32,24,39,120
4374,28,28,21,28,105
4375,24,23,19,21,87
4376,31,38,24,29,122
4377,24,28,26,28,106
4378,13,36,20,30,99
4379,20,22,32,23,97
4380,28,27,27,25,107
4381,19,31,23,24,97
4382,17,34,20,16,87
4383,28,30,24,21,103
4384,22,27,29,23,101
4385,23,29,17,19,88
4386,23,33,17,13,86
4387,19,25,22,23,89
4388,27,26,21,22,96
4389,29,26,25,20,100
4390,31,29,35,30,125
4391,24,31,20,35,110
4392,33,33,26,19,111
4393,23,24,24,19,90
4394,35,32,31,29,127
4395,23,22,23,29,97
4396,19,24,24,32,99
4397,31,28,23,32,114
4398,25,36,30,23,114
4399,28,29,33,28,118
4400,26,32,24,34,116
4401,21,26,15,24,86
4402,23,27,19,22,91
4403,24,34,18,27,103
4404,23,36,32,29,120
4405,31,19,21,39,110
4406,24,31,29,21,105
4407,31,21,18,18,88
4408,22,37,19,25,103
4409,34,32,19,14,99
4410,32,29,26,16,103
4411,22,19,28,24,93
4412,32,19,20,27,98
4413,29,21,33,20,103
4414,21,33,24,16,94
4415,30,31,15,22,98
4416,21,28,15,23,87
4417,28,33,24,28,113
4418,17,23,13,23,76
4419,19,22,17,20,78
4420,30,22,24,31,107
4421,18,29,18,19,84
4422,19,24,26,12,81
4423,27,19,18,21,85
4424,25,26,32,23,106
4425,24,36,26,36,122
4426,25,22,24,27,98
4427,29,25,23,19,96
4428,20,23,32,28,103
4429,25,20,26,20,91
4430,18,21,30,23,92
4431,19,22,17,20,78
4432,17,28,26,21,92
4433,27,28,34,20,109
4434,28,32,18,23,101
4435,31,22,21,25,99
4436,22,21,21,21,85
4437,26,24,23,19,92
4438,21,26,19,25,91
4439,25,25,22,15,87
4440,24,24,34,22,104
4441,31,18,24,20,93
4442,16,27,15,34,92
4443,30,28,23,27,108
4444,18,38,20,36,112
4445,21,34,20,30,105
4446,19,31,20,28,98
4447,21,27,20,29,97
4448,24,31,15,28,98
4449,23,26,32,24,105
4450,19,29,23,22,93
4451,26,29,29,20,104
4452,26,29,23,26,104
4453,18,25,19,21,83
4454,26,27,29,29,111
4455,27,28,26,25,106
4456,22,23,20,18,83
4457,27,28,32,29,116
4458,22,25,28,26,101
4459,25,35,24,23,107
4460,26,34,29,22,111
4461,20,23,21,24,88
4462,27,31,25,22,105
4463,22,19,22,27,90
4464,26,27,31,20,104
4465,36,38,30,29,133
4466,19,30,28,37,114
4467,25,19,19,30,93
4468,30,25,32,25,112
4469,23,23,10,17,73
4470,27,28,27,23,105
4471,26,27,21,21,95
4472,26,32,17,28,103
4473,29,35,32,26,122
4474,25,25,22,33,105
4475,21,31,24,28,104
4476,31,25,16,23,95
4477,22,24,22,29,97
4478,23,28,21,28,100
4479,27,19,21,20,87
4480,23,23,20,27,93
4481,27,23,20,26,96
4482,28,23,32,24,107
4483,21,35,15,26,97
4484,19,24,22,21,86
4485,27,23,24,29,103
4486,34,32,25,25,116
4487,22,30,22,28,102
4488,20,29,20,26,95
4489,17,33,15,27,92
4490,26,32,22,27,107
4491,15,16,14,23,68
4492,23,31,27,32,113
4493,15,28,27,28,98
4494,23,27,22,28,100
4495,26,23,26,31,106
4496,16,40,25,32,113
4497,27,29,25,31,112
4498,23,30,32,30,115
4499,24,26,23,30,103
4500,28,31,13,28,100
4501,20,29,22,25,96
4502,26,30,32,26,114
4503,24,33,27,22,106
4504,22,32,27,30,111
4505,20,25,25,29,99
4506,22,29,23,30,104
4507,16,28,24,24,92
4508,19,25,20,27,91
4509,33,25,34,25,117
4510,19,35,23,27,104
4511,22,25,25,22,94
4512,29,30,23,32,114
4513,29,28,24,22,103
4514,25,19,16,24,84
4515,25,28,30,21,104
4516,17,21,31,26,95
4517,28,33,22,35,118
4518,32,25,21,22,100
4519,19,36,20,23,98
4520,21,31,16,28,96
4521,27,21,18,20,86
4522,26,20,21,29,96
4523,19,28,26,21,94
4524,22,31,27,27,107
4525,28,30,23,25,106
4526,28,33,27,25,113
4527,21,31,26,33,111
4528,28,29,31,22,110
4529,22,21,22,23,88
4530,29,22,31,22,104
4531,28,37,20,20,105
4532,22,23,24,31,100
4533,27,24,20,23,94
4534,23,30,20,27,100
4535,30,23,23,26,102
4536,24,37,35,16,112
4537,25,22,16,14,77
4538,18,36,22,25,101
4539,21,32,31,24,108
4540,22,23,24,27,96
4541,24,28,17,20,89
4542,30,25,35,37,127
4543,22,32,19,31,104
4544,25,21,23,28,97
4545,28,33,25,23,109
4546,23,27,15,23,88
4547,26,32,23,23,104
4548,22,28,24,29,103
4549,29,21,23,28,101
4550,26,50,25,28,129
4551,17,43,26,29,115
4552,27,33,16,22,98
4553,21,31,28,25,105
4554,33,27,19,30,109
4555,19,21,22,18,80
4556,21,28,28,29,106
4557,25,28,29,28,110
4558,30,34,23,16,103
4559,23,35,20,23,101
4560,28,33,21,27,109
4561,29,23,20,27,99
4562,22,30,20,23,95
4563,26,29,29,29,113
4564,30,34,26,29,119
4565,23,27,22,23,95
4566,23,24,14,32,93
4567,23,32,32,22,109
4568,34,28,20,21,103
4569,28,32,25,21,106
4570,26,28,27,23,104
4571,27,28,28,25,108
4572,21,19,24,26,90
4573,23,25,30,29,107
4574,20,18,17,23,78
4575,28,24,38,17,107
4576,19,28,24,23,94
4577,25,29,30,24,108
4578,22,35,28,20,105
4579,28,33,20,19,100
4580,17,20,27,23,87
4581,33,17,21,24,95
4582,29,23,21,28,101
4583,31,23,21,24,99
4584,20,25,27,25,97
4585,16,20,28,23,87
4586,35,25,16,26,102
4587,18,26,22,19,85
4588,21,33,22,15,91
4589,18,37,21,23,99
4590,18,21,17,15,71
4591,29,16,26,17,88
4592,26,25,24,30,105
4593,28,32,19,26,105
4594,22,25,32,20,99
4595,16,25,26,30,97
4596,30,31,20,30,111
4597,25,25,18,18,86
4598,20,27,24,20,91
4599,29,32,23,18,102
4600,21,33,22,30,106
4601,27,31,26,16,100
4602,25,23,25,15,88
4603,26,29,28,29,112
4604,20,23,30,24,97
4605,25,34,17,16,92
4606,20,33,29,27,109
4607,18,29,20,17,84
4608,19,23,17,29,88
4609,17,31,25,30,103
4610,23,26,24,25,98
4611,16,29,36,26,107
4612,25,24,29,31,109
4613,17,22,18,27,84
4614,24,28,23,30,105
4615,27,25,20,28,100
4616,23,26,26,27,102
4617,24,19,26,25,94
4618,20,31,25,24,100
4619,27,26,27,20,100
4620,20,28,18,23,89
4621,24,29,29,21,103
4622,22,18,20,29,89
4623,31,30,23,24,108
4624,27,29,27,25,108
4625,22,32,21,13,88
4626,23,35,27,22,107
4627,20,27,25,24,96
4628,14,32,20,19,85
4629,32,27,28,24,111
4630,23,35,20,23,101
4631,25,19,23,16,83
4632,33,25,23,28,109
4633,30,34,23,20,107
4634,25,29,28,23,105
4635,26,34,20,27,107
4636,24,35,22,23,104
4637,26,26,21,24,97
4638,25,35,24,17,101
4639,16,21,20,28,85
4640,21,23,21,31,96
4641,28,26,24,32,110
4642,23,25,21,21,90
4643,28,27,22,15,92
4644,35,30,30,26,121
4645,20,24,31,29,104
4646,24,30,23,32,109
4647,25,22,25,25,97
4648,26,26,24,25,101
4649,16,19,20,25,80
4650,22,29,29,25,105
4651,19,38,19,27,103
4652,17,25,19,23,84
4653,23,23,23,38,107
4654,23,31,27,27,108
4655,20,28,26,16,90
4656,26,26,21,30,103
4657,15,26,25,22,88
4658,26,26,28,25,105
4659,24,29,27,16,96
4660,33,32,17,25,107
4661,16,25,20,23,84
4662,26,25,20,23,94
4663,24,29,21,20,94
4664,23,23,26,25,97
4665,27,21,25,28,101
4666,16,25,28,29,98
4667,29,27,24,20,100
4668,24,26,24,28,102
4669,35,33,16,18,102
4670,21,21,23,27,92
4671,28,25,19,24,96
4672,23,27,16,28,94
4673,22,27,24,22,95
4674,21,34,29,28,112
4675,19,16,17,19,71
4676,33,24,22,32,111
4677,26,31,22,29,108
4678,28,24,19,24,95
4679,31,26,10,20,87
4680,24,34,15,24,97
4681,36,29,30,19,114
4682,27,24,19,22,92
4683,20,27,21,20,88
4684,30,30,18,32,110
4685,19,27,31,32,109
4686,29,28,30,25,112
4687,19,27,33,33,112
4688,23,23,24,28,98
4689,24,25,28,30,107
4690,21,20,25,24,90
4691,26,26,20,26,98
4692,20,27,18,15,80
4693,23,29,22,25,99
4694,25,32,27,31,115
4695,31,31,18,32,112
4696,37,23,25,29,114
4697,19,32,19,31,101
4698,27,27,28,25,107
4699,23,35,20,36,114
4700,22,21,24,29,96
4701,33,34,22,23,112
4702,24,24,28,16,92
4703,21,22,13,34,90
4704,21,28,22,17,88
4705,27,34,18,29,108
4706,21,27,27,20,95
4707,20,36,21,30,107
4708,26,30,20,26,102
4709,27,25,21,18,91
4710,26,29,23,20,98
4711,25,33,22,27,107
4712,33,35,19,23,110
4713,32,31,25,22,110
4714,26,24,17,24,91
4715,27,26,22,26,101
4716,17,21,31,24,93
4717,27,34,20,17,98
4718,23,27,19,28,97
4719,33,25,28,15,101
4720,22,35,14,22,93
4721,25,30,24,18,97
4722,20,25,16,23,84
4723,17,30,29,17,93
4724,29,29,23,19,100
4725,18,22,17,24,81
4726,22,31,27,16,96
4727,20,30,19,26,95
4728,32,27,21,21,101
4729,19,17,20,20,76
4730,20,25,28,20,93
4731,29,24,25,22,100
4732,28,28,31,27,114
4733,31,32,26,28,117
4734,29,32,25,25,111
4735,23,30,20,26,99
4736,17,41,33,25,116
4737,24,28,22,24,98
4738,27,23,22,26,98
4739,34,27,25,31,117
4740,23,24,27,28,102
4741,28,29,26,20,103
4742,23,24,25,34,106
4743,18,38,22,17,95
4744,25,26,24,23,98
4745,20,22,24,27,93
4746,30,14,27,21,92
4747,13,26,18,22,79
4748,21,37,27,23,108
4749,24,40,21,21,106
4750,25,33,25,21,104
4751,25,22,19,23,89
4752,25,25,17,25,92
4753,25,29,27,29,110
4754,32,30,18,19,99
4755,19,28,16,20,83
4756,21,32,27,26,106
4757,18,26,27,15,86
4758,27,20,21,28,96
4759,21,30,25,34,110
4760,20,23,23,30,96
4761,18,31,20,23,92
4762,23,29,25,26,103
4763,24,18,20,30,92
4764,27,26,19,34,106
4765,26,27,32,25,110
4766,30,31,26,16,103
4767,25,18,25,30,98
4768,20,24,22,31,97
4769,26,25,31,25,107
4770,21,28,17,24,90
4771,33,31,24,26,114
4772,18,33,22,26,99
4773,25,28,19,19,91
4774,27,20,29,24,100
4775,22,29,25,25,101
4776,28,33,12,22,95
4777,19,25,28,32,104
4778,24,34,24,19,101
4779,15,19,32,15,81
4780,22,24,28,34,108
4781,21,23,30,26,100
4782,29,30,21,26,106
4783,24,31,28,23,106
4784,25,28,22,28,103
4785,24,27,27,7,85
4786,23,35,17,34,109
4787,37,26,22,27,112
4788,21,26,17,29,93
4789,21,27,21,23,92
4790,20,27,14,31,92
4791,29,42,15,24,110
4792,22,39,33,24,118
4793,23,40,25,22,110
4794,24,34,28,22,108
4795,21,24,29,20,94
4796,24,32,34,30,120
4797,22,21,32,30,105
4798,35,20,17,21,93
4799,22,28,39,22,111
4800,29,39,24,35,127
4801,31,24,19,28,102
4802,21,29,36,25,111
4803,17,29,17,21,84
4804,19,31,23,30,103
4805,26,32,26,28,112
4806,23,26,15,34,98
4807,21,31,24,18,94
4808,24,20,23,31,98
4809,22,25,25,34,106
4810,18,19,28,23,88
4811,29,35,22,25,111
4812,24,31,21,29,105
4813,23,27,26,17,93
4814,14,18,19,15,66
4815,22,24,20,22,88
4816,23,28,25,36,112
4817,34,35,29,28,126
4818,27,34,22,26,109
4819,30,24,25,27,106
4820,25,29,25,22,101
4821,30,30,27,28,115
4822,31,26,47,20,124
4823,20,24,17,18,79
4824,25,30,22,28,105
4825,21,37,32,20,110
4826,16,25,24,24,89
4827,19,32,25,25,101
4828,22,36,24,27,109
4829,27,36,16,22,101
4830,25,26,26,27,104
4831,20,21,18,21,80
4832,21,31,21,26,99
4833,32,30,22,29,113
4834,20,22,23,34,99
4835,24,35,20,30,109
4836,22,39,30,19,110
4837,20,29,20,18,87
4838,31,19,23,19,92
4839,33,32,27,26,118
4840,28,27,29,23,107
4841,25,33,26,31,115
4842,24,20,23,28,95
4843,22,27,27,18,94
4844,33,30,31,34,128
4845,27,27,34,14,102
4846,31,27,19,29,106
4847,34,32,21,18,105
4848,25,30,30,21,106
4849,26,32,28,23,109
4850,20,33,23,23,99
4851,16,27,21,26,90
4852,28,28,19,25,100
4853,31,27,19,23,100
4854,24,17,35,20,96
4855,29,23,40,23,115
4856,31,31,26,25,113
4857,16,18,14,19,67
4858,25,26,19,21,91
4859,28,26,27,20,101
4860,23,19,24,27,93
4861,17,27,30,32,106
4862,28,26,24,28,106
4863,26,26,19,22,93
4864,28,25,28,26,107
4865,24,28,22,14,88
4866,22,31,37,30,120
4867,20,33,29,26,108
4868,22,32,25,23,102
4869,24,26,17,28,95
4870,27,34,21,25,107
4871,26,23,27,26,102
4872,24,22,22,25,93
4873,23,23,24,29,99
4874,26,24,16,36,102
4875,25,20,17,18,80
4876,22,22,17,23,84
4877,28,39,26,24,117
4878,23,26,24,25,98
4879,17,33,28,20,98
4880,24,29,28,21,102
4881,31,32,31,26,120
4882,30,35,24,25,114
4883,18,21,16,23,78
4884,25,30,24,29,108
4885,22,36,20,33,111
4886,18,22,18,19,77
4887,24,28,23,33,108
4888,33,22,21,33,109
4889,22,29,17,20,88
4890,18,38,23,17,96
4891,36,37,16,23,112
4892,26,19,20,13,78
4893,31,36,20,23,110
4894,22,27,24,27,100
4895,24,25,26,30,105
4896,32,34,22,21,109
4897,20,25,22,20,87
4898,27,31,16,27,101
4899,17,18,25,23,83
4900,28,25,24,24,101
4901,19,27,18,26,90
4902,24,23,23,19,89
4903,24,29,13,27,93
4904,22,21,18,21,82
4905,22,23,25,23,93
4906,20,29,21,24,94
4907,24,26,24,28,102
4908,35,23,22,16,96
4909,24,26,26,29,105
4910,19,31,20,23,93
4911,21,33,22,20,96
4912,29,21,28,24,102
4913,23,18,19,19,79
4914,31,31,24,27,113
4915,24,33,26,29,112
4916,24,32,26,23,105
4917,23,26,22,26,97
4918,27,29,22,27,105
4919,35,31,23,16,105
4920,26,24,20,25,95
4921,17,31,30,30,108
4922,17,29,11,23,80
4923,23,30,27,20,100
4924,18,30,24,25,97
4925,26,20,25,26,97
4926,24,20,33,18,95
4927,23,30,21,35,109
4928,25,24,17,22,88
4929,25,34,23,20,102
4930,17,22,21,32,92
4931,19,22,23,26,90
4932,25,27,25,23,100
4933,28,29,21,18,96
4934,24,25,22,36,107
4935,21,26,21,27,95
4936,20,19,25,26,90
4937,26,22,23,31,102
4938,33,23,27,19,102
4939,23,28,22,28,101
4940,38,21,31,19,109
4941,24,19,28,22,93
4942,24,35,16,24,99
4943,23,34,27,26,110
4944,22,34,26,29,111
4945,27,26,24,27,104
4946,16,30,20,23,89
4947,31,22,22,22,97
4948,25,27,19,21,92
4949,30,37,40,21,128
4950,33,24,22,31,110
4951,25,34,29,25,113
4952,26,40,17,22,105
4953,36,31,18,26,111
4954,22,27,11,23,83
4955,20,23,29,27,99
4956,27,29,28,35,119
4957,27,25,25,22,99
4958,22,21,28,20,91
4959,25,23,22,30,100
4960,32,24,27,31,114
4961,21,27,28,16,92
4962,30,25,23,22,100
4963,20,24,17,18,79
4964,31,38,24,24,117
4965,21,32,26,29,108
4966,31,36,22,29,118
4967,24,30,18,31,103
4968,28,34,28,22,112
4969,33,32,25,17,107
4970,19,26,24,24,93
4971,26,38,17,35,116
4972,22,25,23,23,93
4973,20,24,24,22,90
4974,23,30,25,34,112
4975,22,26,28,22,98
4976,22,25,23,17,87
4977,21,20,26,22,89
4978,28,26,23,16,93
4979,27,26,29,25,107
4980,36,29,16,23,104
4981,20,24,29,25,98
4982,28,29,26,21,104
4983,25,20,19,24,88
4984,22,31,18,17,88
4985,33,23,26,25,107
4986,29,32,21,22,104
4987,18,21,20,18,77
4988,24,28,29,32,113
4989,26,26,24,31,107
4990,31,27,28,22,108
4991,28,26,24,32,110
4992,25,27,25,24,101
4993,17,26,21,16,80
4994,23,28,20,18,89
4995,13,23,19,14,69
4996,16,30,19,23,88
4997,25,21,25,32,103
4998,31,25,25,29,110
4999,22,26,27,31,106
5000,23,19,26,16,84
5001,25,27,21,31,104
5002,30,34,22,30,116
5003,29,22,24,33,108
5004,20,26,32,37,115
5005,26,28,20,26,100
5006,24,27,18,25,94
5007,23,30,22,25,100
5008,25,29,20,27,101
5009,32,24,14,25,95
5010,25,25,25,29,104
5011,18,23,29,26,96
5012,22,31,28,29,110
5013,24,25,22,23,94
5014,18,25,28,20,91
5015,18,23,19,21,81
5016,25,31,25,20,101
5017,25,21,27,18,91
5018,22,26,26,21,95
5019,23,27,33,22,105
5020,25,22,25,23,95
5021,23,27,21,25,96
5022,26,32,17,31,106
5023,23,25,13,19,80
5024,23,25,26,28,102
5025,29,27,31,21,108
5026,22,30,22,23,97
5027,16,34,28,26,104
5028,28,27,26,22,103
5029,23,26,18,22,89
5030,18,26,25,17,86
5031,21,30,32,22,105
5032,26,26,21,35,108
5033,29,33,23,32,117
5034,24,16,30,23,93
5035,23,31,22,25,101
5036,29,28,20,29,106
5037,33,33,24,23,113
5038,30,31,21,25,107
5039,23,39,22,19,103
5040,26,25,21,19,91
5041,19,22,11,17,69
5042,32,28,29,37,126
5043,22,26,25,37,110
5044,24,28,22,30,104
5045,28,33,28,30,119
5046,21,27,32,26,106
5047,35,29,21,27,112
5048,27,24,17,19,87
5049,22,33,17,21,93
5050,20,30,23,28,101
5051,25,28,17,24,94
5052,28,40,19,19,106
5053,26,26,18,32,102
5054,21,27,25,23,96
5055,23,21,38,17,99
5056,20,28,36,24,108
5057,31,26,19,20,96
5058,25,30,33,31,119
5059,22,29,17,28,96
5060,21,22,28,35,106
5061,20,29,19,35,103
5062,27,31,19,24,101
5063,30,24,22,23,99
5064,24,23,24,29,100
5065,32,27,25,28,112
5066,25,32,25,28,110
5067,27,30,25,22,104
5068,28,29,29,19,105
5069,26,31,24,22,103
5070,27,21,24,27,99
5071,33,26,25,19,103
5072,21,29,22,35,107
5073,31,27,27,23,108
5074,22,24,20,28,94
5075,22,30,26,24,102
5076,23,29,25,23,100
5077,19,33,30,20,102
5078,19,25,16,27,87
5079,22,22,24,27,95
5080,22,23,20,19,84
5081,17,27,23,24,91
5082,23,34,19,19,95
5083,25,26,30,22,103
5084,31,27,26,25,109
5085,20,29,21,21,91
5086,25,25,26,23,99
5087,27,29,22,25,103
5088,22,37,23,19,101
5089,23,30,34,25,112
5090,23,39,20,30,112
5091,27,28,28,17,100
5092,17,29,20,23,89
5093,20,23,24,26,93
5094,14,35,19,27,95
5095,27,28,28,30,113
5096,18,22,22,40,102
5097,17,28,24,19,88
5098,15,22,28,28,93
5099,23,31,24,21,99
5100,20,23,22,26,91
5101,18,29,25,25,97
5102,28,33,26,25,112
5103,41,24,22,20,107
5104,20,27,29,20,96
5105,32,18,24,26,100
5106,29,32,29,22,112
5107,20,21,26,32,99
5108,23,21,17,28,89
5109,21,22,22,18,83
5110,31,40,30,24,125
5111,31,23,18,31,103
5112,18,35,39,19,111
5113,23,26,35,19,103
5114,18,28,26,20,92
5115,23,27,32,23,105
5116,22,30,20,34,106
5117,25,25,23,12,85
5118,17,27,18,27,89
5119,20,21,26,23,90
5120,30,24,24,23,101
5121,29,25,27,25,106
5122,29,30,16,26,101
5123,20,32,22,25,99
5124,30,23,23,24,100
5125,17,24,16,24,81
5126,24,29,19,16,88
5127,23,25,28,23,99
5128,28,25,29,25,107
5129,25,32,23,25,105
5130,25,24,29,23,101
5131,24,30,22,22,98
5132,26,29,25,16,96
5133,20,29,20,23,92
5134,25,32,23,25,105
5135,26,29,20,26,101
5136,25,24,17,22,88
5137,23,32,21,20,96
5138,26,26,25,23,100
5139,23,35,19,28,105
5140,21,37,24,31,113
5141,19,24,15,23,81
5142,13,24,28,29,94
5143,30,32,26,23,111
5144,24,27,23,22,96
5145,20,27,31,26,104
5146,24,25,26,27,102
5147,30,40,32,22,124
5148,31,33,20,20,104
5149,27,37,23,24,111
5150,23,26,23,22,94
5151,23,27,26,36,112
5152,19,33,22,25,99
5153,25,27,24,22,98
5154,31,29,21,35,116
5155,21,25,26,27,99
5156,20,32,27,36,115
5157,22,28,20,24,94
5158,22,27,17,17,83
5159,21,32,23,32,108
5160,29,33,24,28,114
5161,15,21,25,20,81
5162,18,21,21,19,79
5163,22,36,24,23,105
5164,29,33,29,25,116
5165,18,27,23,26,94
5166,23,37,25,19,104
5167,28,31,29,23,111
5168,19,31,29,21,100
5169,23,29,20,35,107
5170,30,27,28,27,112
5171,22,24,17,31,94
5172,21,29,25,25,100
5173,24,26,21,23,94
5174,36,34,21,29,120
5175,28,29,17,33,107
5176,28,22,23,21,94
5177,19,39,29,30,117
5178,28,31,29,28,116
5179,22,25,30,25,102
5180,25,33,25,21,104
5181,28,27,23,25,103
5182,24,27,31,23,105
5183,21,24,20,24,89
5184,29,27,17,19,92
5185,26,22,19,18,85
5186,21,33,23,27,104
5187,27,34,17,25,103
5188,24,28,21,22,95
5189,31,27,16,23,97
5190,24,21,30,28,103
5191,29,32,17,24,102
5192,32,17,28,36,113
5193,24,25,25,24,98
5194,22,28,26,34,110
5195,22,27,38,25,112
5196,26,21,23,30,100
5197,22,37,23,26,108
5198,22,33,32,28,115
5199,31,31,23,25,110
5200,25,22,22,18,87
5201,24,29,27,19,99
5202,25,29,23,26,103
5203,31,30,16,33,110
5204,22,23,24,28,97
5205,22,31,25,22,100
5206,19,29,22,22,92
5207,23,33,22,22,100
5208,22,26,29,29,106
5209,26,16,25,23,90
5210,19,33,25,29,106
5211,24,32,16,23,95
5212,13,22,32,16,83
5213,29,34,19,25,107
5214,26,28,18,32,104
5215,18,26,15,17,76
5216,23,25,25,30,103
5217,30,29,23,23,105
5218,28,27,34,24,113
5219,24,28,11,21,84
5220,27,30,26,26,109
5221,19,42,23,20,104
5222,27,30,31,16,104
5223,27,31,30,23,111
5224,20,24,19,17,80
5225,28,17,21,19,85
5226,27,15,19,21,82
5227,24,19,22,22,87
5228,23,24,24,28,99
5229,31,25,21,27,104
5230,31,25,20,28,104
5231,21,32,28,26,107
5232,27,25,27,21,100
5233,28,30,21,35,114
5234,26,32,23,20,101
5235,31,30,18,27,106
5236,21,32,29,18,100
5237,17,27,21,27,92
5238,25,26,27,24,102
5239,29,27,20,23,99
5240,30,30,21,24,105
5241,34,21,30,29,114
5242,29,28,23,27,107
5243,28,38,30,26,122
5244,35,37,26,26,124
5245,26,28,33,27,114
5246,28,31,19,21,99
5247,32,31,22,22,107
5248,27,33,22,27,109
5249,27,34,26,22,109
5250,25,23,32,25,105
5251,33,24,16,26,99
5252,23,25,26,19,93
5253,28,26,11,25,90
5254,25,32,20,21,98
5255,22,39,22,25,108
5256,23,24,28,28,103
5257,17,29,27,26,99
5258,24,28,23,17,92
5259,20,25,28,27,100
5260,17,30,30,28,105
5261,19,31,27,31,108
5262,25,26,24,17,92
5263,19,30,20,16,85
5264,31,23,29,19,102
5265,17,39,26,19,101
5266,19,21,20,29,89
5267,20,21,18,33,92
5268,22,23,21,27,93
5269,17,23,15,25,80
5270,24,27,23,23,97
5271,22,25,17,23,87
5272,23,33,25,22,103
5273,25,23,26,23,97
5274,30,26,32,23,111
5275,33,26,23,26,108
5276,24,29,22,20,95
5277,17,30,25,30,102
5278,23,42,23,22,110
5279,25,30,22,25,102
5280,33,23,19,27,102
5281,21,18,24,26,89
5282,23,29,22,30,104
5283,31,28,22,30,111
5284,23,26,22,26,97
5285,20,19,14,20,73
5286,22,28,21,28,99
5287,17,27,24,22,90
5288,29,30,32,19,110
5289,19,21,22,26,88
5290,28,27,30,28,113
5291,21,29,19,31,100
5292,25,28,18,20,91
5293,27,22,22,28,99
5294,16,25,22,25,88
5295,18,23,26,25,92
5296,25,23,21,20,89
5297,23,27,28,17,95
5298,23,36,14,30,103
5299,16,33,27,23,99
5300,28,24,26,28,106
5301,26,28,27,29,110
5302,21,29,20,27,97
5303,25,24,32,25,106
5304,25,25,20,24,94
5305,28,25,24,22,99
5306,27,33,16,20,96
5307,35,22,37,23,117
5308,20,33,24,28,105
5309,22,27,16,31,96
5310,22,23,21,19,85
5311,23,30,29,22,104
5312,20,34,25,19,98
5313,28,23,25,28,104
5314,22,30,23,27,102
5315,21,24,24,19,88
5316,31,30,27,27,115
5317,18,27,21,24,90
5318,25,37,28,25,115
5319,26,25,21,25,97
5320,16,18,24,30,88
5321,19,23,24,26,92
5322,22,21,22,29,94
5323,24,24,22,21,91
5324,19,30,22,29,100
5325,18,28,20,26,92
5326,25,22,22,36,105
5327,36,25,25,21,107
5328,22,35,27,17,101
5329,15,28,25,22,90
5330,21,17,27,19,84
5331,26,27,25,30,108
5332,18,28,13,36,95
5333,28,30,23,24,105
5334,21,30,18,26,95
5335,19,24,27,17,87
5336,23,36,15,23,97
5337,16,29,19,22,86
5338,19,21,23,32,95
5339,24,29,20,32,105
5340,33,29,31,24,117
5341,19,24,19,24,86
5342,24,30,24,19,97
5343,23,26,30,31,110
5344,30,28,24,22,104
5345,27,24,25,26,102
5346,17,29,25,24,95
5347,26,20,21,23,90
5348,24,30,23,26,103
5349,22,32,16,13,83
5350,25,24,32,22,103
5351,28,26,24,20,98
5352,24,31,22,29,106
5353,21,36,29,19,105
5354,31,33,26,23,113
5355,15,29,22,18,84
5356,25,22,26,30,103
5357,32,28,25,25,110
5358,21,30,30,29,110
5359,27,22,27,25,101
5360,22,16,23,24,85
5361,25,36,22,26,109
5362,17,27,27,24,95
5363,29,25,28,29,111
5364,29,27,20,27,103
5365,36,24,27,28,115
5366,18,18,23,19,78
5367,18,21,25,22,86
5368,27,20,20,14,81
5369,24,26,19,19,88
5370,29,23,22,28,102
5371,26,38,21,24,109
5372,19,33,25,24,101
5373,23,31,25,22,101
5374,32,32,25,19,108
5375,23,30,22,21,96
5376,24,36,27,20,107
5377,29,23,37,26,115
5378,20,24,19,29,92
5379,19,28,31,24,102
5380,33,40,25,23,121
5381,27,32,26,29,114
5382,20,30,17,33,100
5383,21,35,29,24,109
5384,28,28,19,27,102
5385,14,32,24,19,89
5386,27,23,19,25,94
5387,24,16,31,34,105
5388,16,20,14,13,63
5389,29,28,22,37,116
5390,25,19,13,31,88
5391,17,27,24,34,102
5392,28,35,26,20,109
5393,22,18,25,23,88
5394,27,31,18,32,108
5395,30,25,38,23,116
5396,33,24,22,14,93
5397,21,35,21,28,105
5398,27,23,20,20,90
5399,20,24,27,34,105
5400,22,36,19,25,102
5401,29,31,22,19,101
5402,24,31,29,23,107
5403,20,25,31,24,100
5404,26,33,25,22,106
5405,20,29,30,25,104
5406,23,32,16,28,99
5407,24,39,23,28,114
5408,27,27,21,23,98
5409,22,25,21,29,97
5410,23,38,35,23,119
5411,26,26,30,24,106
5412,22,29,19,23,93
5413,23,33,19,28,103
5414,25,22,29,31,107
5415,20,26,28,12,86
5416,22,27,36,15,100
5417,26,29,27,18,100
5418,27,25,23,24,99
5419,29,30,25,24,108
5420,30,16,20,22,88
5421,21,24,22,16,83
5422,23,32,22,25,102
5423,23,30,22,21,96
5424,21,34,16,28,99
5425,26,27,18,28,99
5426,18,28,24,27,97
5427,30,36,12,30,108
5428,24,24,23,29,100
5429,27,25,24,27,103
5430,33,28,37,25,123
5431,25,15,26,26,92
5432,27,32,26,34,119
5433,27,38,22,24,111
5434,27,27,33,24,111
5435,21,27,32,20,100
5436,21,29,25,26,101
5437,26,25,28,25,104
5438,24,35,24,15,98
5439,23,30,23,22,98
5440,27,27,23,27,104
5441,21,34,21,23,99
5442,21,26,22,28,97
5443,20,22,20,25,87
5444,22,31,30,21,104
5445,28,34,19,26,107
5446,22,23,22,25,92
5447,24,22,30,25,101
5448,21,25,23,21,90
5449,24,31,19,17,91
5450,19,33,30,25,107
5451,23,20,25,29,97
5452,40,27,22,19,108
5453,17,28,23,25,93
5454,30,26,17,24,97
5455,20,29,24,22,95
5456,25,26,31,24,106
5457,21,33,21,34,109
5458,32,39,25,15,111
5459,30,26,25,32,113
5460,16,26,27,23,92
5461,26,27,33,24,110
5462,33,28,25,32,118
5463,18,24,28,22,92
5464,22,29,29,22,102
5465,31,29,28,27,115
5466,19,33,22,35,109
5467,21,19,25,24,89
5468,28,27,18,30,103
5469,25,27,24,29,105
5470,21,25,20,21,87
5471,28,30,26,25,109
5472,26,33,22,33,114
5473,28,19,22,20,89
5474,24,26,21,21,92
5475,20,29,20,17,86
5476,36,28,31,25,120
5477,22,28,14,27,91
5478,20,28,29,25,102
5479,22,13,15,16,66
5480,30,19,25,17,91
5481,30,32,19,11,92
5482,30,19,34,20,103
5483,29,28,20,25,102
5484,27,35,21,26,109
5485,27,20,19,25,91
5486,27,20,25,15,87
5487,35,33,21,26,115
5488,26,36,31,16,109
5489,20,22,27,30,99
5490,18,27,23,20,88
5491,16,23,21,21,81
5492,27,29,15,31,102
5493,30,38,20,21,109
5494,25,22,21,29,97
5495,14,38,18,24,94
5496,19,23,17,26,85
5497,20,31,17,22,90
5498,23,34,24,23,104
5499,22,31,25,19,97
5500,18,35,22,25,100
5501,20,34,23,26,103
5502,23,20,12,32,87
5503,27,24,32,25,108
5504,26,26,10,28,90
5505,27,26,25,19,97
5506,22,36,23,27,108
5507,28,36,15,24,103
5508,27,23,20,27,97
5509,23,24,23,26,96
5510,28,28,32,20,108
5511,25,22,17,18,82
5512,24,22,30,28,104
5513,25,23,33,26,107
5514,25,35,21,35,116
5515,29,24,20,20,93
5516,31,26,23,27,107
5517,22,29,23,28,102
5518,16,23,21,24,84
5519,29,37,25,27,118
5520,21,28,23,31,103
5521,23,32,19,21,95
5522,23,31,30,29,113
5523,22,33,23,19,97
5524,24,28,27,33,112
5525,27,35,22,32,116
5526,26,28,25,37,116
5527,25,29,22,29,105
5528,20,31,22,29,102
5529,25,32,27,26,110
5530,22,32,16,26,96
5531,23,23,18,20,84
5532,20,26,26,26,98
5533,27,28,28,22,105
5534,37,24,34,24,119
5535,19,29,23,22,93
5536,20,30,24,24,98
5537,22,29,23,31,105
5538,23,32,18,24,97
5539,23,24,15,26,88
5540,17,24,20,26,87
5541,23,31,29,15,98
5542,22,27,25,23,97
5543,22,22,29,24,97
5544,21,26,18,23,88
5545,30,16,17,20,83
5546,24,24,21,29,98
5547,29,30,29,25,113
5548,19,37,24,24,104
5549,23,27,14,24,88
5550,20,25,25,34,104
5551,20,40,24,29,113
5552,22,40,29,24,115
5553,28,30,22,19,99
5554,27,24,23,24,98
5555,22,31,23,22,98
5556,29,32,26,27,114
5557,26,25,19,17,87
5558,13,23,18,18,72
5559,31,32,30,21,114
5560,24,34,18,24,100
5561,19,21,20,29,89
5562,21,21,17,26,85
5563,29,29,19,24,101
5564,12,22,20,27,81
5565,29,24,24,19,96
5566,25,22,18,22,87
5567,20,29,24,24,97
5568,31,25,27,28,111
5569,19,36,23,22,100
5570,16,37,27,32,112
5571,24,30,19,22,95
5572,21,25,24,30,100
5573,29,18,19,26,92
5574,27,33,25,26,111
5575,24,18,24,26,92
5576,21,33,21,28,103
5577,18,30,17,20,85
5578,16,33,18,24,91
5579,32,30,24,20,106
5580,20,28,32,23,103
5581,31,33,20,29,113
5582,22,23,16,20,81
5583,35,26,17,26,104
5584,16,30,29,13,88
5585,19,20,20,23,82
5586,23,36,22,21,102
5587,25,17,26,26,94
5588,25,34,31,21,111
5589,26,32,20,30,108
5590,27,22,31,30,110
5591,25,26,18,26,95
5592,34,30,18,24,106
5593,19,21,15,15,70
5594,21,26,21,26,94
5595,20,22,30,24,96
5596,38,25,21,16,100
5597,20,28,35,18,101
5598,18,31,27,24,100
5599,25,28,20,31,104
5600,27,23,23,31,104
5601,23,26,20,24,93
5602,16,24,16,32,88
5603,22,29,20,17,88
5604,24,30,24,23,101
5605,24,24,21,28,97
5606,16,21,24,27,88
5607,28,22,29,14,93
5608,25,32,29,16,102
5609,27,26,25,25,103
5610,21,23,26,28,98
5611,18,38,26,33,115
5612,17,32,25,21,95
5613,19,28,13,30,90
5614,28,35,24,24,111
5615,32,22,34,31,119
5616,21,26,29,20,96
5617,28,26,25,37,116
5618,20,34,23,16,93
5619,32,26,24,22,104
5620,20,24,25,21,90
5621,27,28,18,27,100
5622,20,20,22,22,84
5623,28,23,30,32,113
5624,23,20,21,11,75
5625,20,32,28,23,103
5626,13,30,14,23,80
5627,23,35,30,26,114
5628,21,28,28,22,99
5629,18,26,24,26,94
5630,23,35,20,24,102
5631,19,24,19,22,84
5632,22,27,26,22,97
5633,22,20,22,25,89
5634,17,32,18,24,91
5635,17,24,23,32,96
5636,19,30,17,23,89
5637,26,30,19,30,105
5638,24,25,22,29,100
5639,28,24,19,25,96
5640,35,25,25,21,106
5641,29,18,26,15,88
5642,24,21,25,24,94
5643,25,32,25,23,105
5644,30,33,24,20,107
5645,38,26,19,23,106
5646,22,18,30,26,96
5647,17,15,15,18,65
5648,38,24,20,15,97
5649,21,23,32,24,100
5650,23,27,24,15,89
5651,28,25,20,22,95
5652,27,22,21,24,94
5653,27,27,30,26,110
5654,23,31,26,23,103
5655,23,29,27,27,106
5656,20,28,21,30,99
5657,29,23,20,21,93
5658,24,34,19,29,106
5659,25,24,30,22,101
5660,30,22,17,27,96
5661,25,41,33,21,120
5662,19,31,22,18,90
5663,25,27,22,21,95
5664,20,29,22,20,91
5665,30,27,27,29,113
5666,22,24,20,26,92
5667,23,31,30,21,105
5668,26,29,30,16,101
5669,27,27,35,23,112
5670,22,28,31,17,98
5671,23,34,14,28,99
5672,25,21,25,23,94
5673,25,28,24,24,101
5674,27,27,20,25,99
5675,30,35,30,25,120
5676,26,34,21,22,103
5677,14,33,24,28,99
5678,27,22,24,22,95
5679,26,30,30,24,110
5680,22,38,22,24,106
5681,30,38,20,23,111
5682,20,40,27,17,104
5683,24,33,28,27,112
5684,26,18,19,30,93
5685,21,27,27,28,103
5686,27,32,21,28,108
5687,24,34,25,26,109
5688,21,25,22,21,89
5689,29,25,26,33,113
5690,29,28,25,26,108
5691,22,25,28,25,100
5692,29,30,29,29,117
5693,17,25,22,26,90
5694,24,21,29,20,94
5695,15,21,20,19,75
5696,22,34,22,35,113
5697,16,28,28,25,97
5698,19,23,27,30,99
5699,25,28,29,29,111
5700,24,29,25,23,101
5701,17,32,20,30,99
5702,18,35,27,28,108
5703,18,22,19,27,86
5704,16,24,28,17,85
5705,26,25,25,15,91
5706,26,23,23,29,101
5707,33,17,24,23,97
5708,30,28,17,27,102
5709,28,27,25,30,110
5710,25,25,22,24,96
5711,23,26,20,31,100
5712,23,26,25,18,92
5713,24,23,21,22,90
5714,21,19,24,32,96
5715,30,23,21,22,96
5716,22,23,29,25,99
5717,34,23,25,24,106
5718,34,26,23,26,109
5719,16,20,34,17,87
5720,23,21,29,22,95
5721,19,24,22,29,94
5722,32,34,21,30,117
5723,24,32,19,28,103
5724,17,24,19,23,83
5725,25,25,23,22,95
5726,23,29,21,26,99
5727,26,30,26,27,109
5728,24,21,19,26,90
5729,24,30,30,20,104
5730,20,23,27,19,89
5731,22,23,24,33,102
5732,16,20,20,20,76
5733,28,27,20,29,104
5734,19,35,17,31,102
5735,18,31,22,22,93
5736,31,32,21,16,100
5737,22,29,20,30,101
5738,23,26,16,18,83
5739,26,28,15,17,86
5740,20,27,27,19,93
5741,22,20,16,23,81
5742,30,28,18,29,105
5743,28,26,22,31,107
5744,27,25,23,22,97
5745,26,26,18,24,94
5746,22,32,25,26,105
5747,25,17,15,22,79
5748,25,32,25,23,105
5749,25,22,25,20,92
5750,23,18,25,24,90
5751,32,24,21,29,106
5752,23,24,17,26,90
5753,24,34,15,23,96
5754,32,37,23,23,115
5755,20,26,17,16,79
5756,33,19,27,20,99
5757,21,23,23,38,105
5758,26,37,24,21,108
5759,27,32,19,24,102
5760,30,29,19,25,103
5761,29,32,21,30,112
5762,29,24,25,23,101
5763,22,23,29,27,101
5764,28,23,30,32,113
5765,28,19,21,17,85
5766,30,24,23,28,105
5767,31,32,23,26,112
5768,19,26,30,21,96
5769,17,29,23,23,92
5770,16,24,27,22,89
5771,25,33,27,29,114
5772,24,22,23,20,89
5773,19,27,28,30,104
5774,27,21,27,22,97
5775,19,35,22,27,103
5776,21,26,18,25,90
5777,23,21,20,22,86
5778,15,28,18,24,85
5779,16,24,18,23,81
5780,19,17,23,13,72
5781,17,26,26,21,90
5782,28,36,27,30,121
5783,25,29,26,30,110
5784,36,23,31,26,116
5785,26,27,21,15,89
5786,26,25,9,12,72
5787,33,30,27,20,110
5788,21,22,20,28,91
5789,24,29,18,20,91
5790,20,27,28,29,104
5791,31,36,19,21,107
5792,30,30,30,32,122
5793,31,25,20,30,106
5794,21,22,18,25,86
5795,25,26,29,24,104
5796,22,24,14,31,91
5797,14,26,25,20,85
5798,22,22,17,29,90
5799,23,29,28,17,97
5800,20,29,25,24,98
5801,34,27,28,34,123
5802,22,33,23,30,108
5803,18,22,21,25,86
5804,19,22,24,19,84
5805,16,21,18,14,69
5806,22,28,27,22,99
5807,28,29,22,14,93
5808,31,29,19,14,93
5809,18,28,26,26,98
5810,28,30,39,23,120
5811,26,32,27,28,113
5812,31,26,22,21,100
5813,36,19,19,21,95
5814,25,23,26,24,98
5815,26,22,29,20,97
5816,26,25,17,23,91
5817,24,23,26,28,101
5818,21,32,35,22,110
5819,31,22,17,25,95
5820,29,36,17,20,102
5821,23,32,22,27,104
5822,16,23,25,16,80
5823,25,29,23,23,100
5824,27,25,16,23,91
5825,20,28,21,22,91
5826,30,24,15,33,102
5827,34,25,31,27,117
5828,29,28,18,32,107
5829,25,22,19,30,96
5830,28,22,27,25,102
5831,21,22,21,19,83
5832,28,24,26,23,101
5833,23,36,16,22,97
5834,25,25,31,31,112
5835,28,28,28,24,108
5836,29,29,24,24,106
5837,21,42,18,29,110
5838,26,30,24,23,103
5839,28,28,28,31,115
5840,24,29,21,27,101
5841,27,22,23,22,94
5842,31,29,22,30,112
5843,30,30,22,42,124
5844,22,26,16,22,86
5845,17,27,25,24,93
5846,30,27,26,28,111
5847,16,18,19,12,65
5848,34,28,30,27,119
5849,27,27,18,28,100
5850,25,34,22,22,103
5851,19,41,28,25,113
5852,35,26,29,20,110
5853,22,23,30,24,99
5854,27,27,16,25,95
5855,26,29,21,18,94
5856,35,25,28,27,115
5857,36,32,20,22,110
5858,26,26,21,24,97
5859,17,34,21,23,95
5860,31,28,24,28,111
5861,21,24,19,19,83
5862,32,34,23,27,116
5863,28,29,24,23,104
5864,20,33,25,33,111
5865,25,26,15,20,86
5866,24,25,24,22,95
5867,33,27,30,26,116
5868,13,28,27,22,90
5869,28,32,22,19,101
5870,17,23,15,21,76
5871,25,32,20,30,107
5872,24,23,24,29,100
5873,19,22,23,11,75
5874,18,28,27,26,99
5875,25,27,20,29,101
5876,14,25,30,20,89
5877,22,35,19,24,100
5878,26,43,20,22,111
5879,26,25,21,22,94
5880,32,32,24,19,107
5881,23,30,26,19,98
5882,22,24,27,30,103
5883,23,24,21,24,92
5884,14,32,20,27,93
5885,22,32,21,17,92
5886,24,18,30,23,95
5887,25,18,16,22,81
5888,21,23,23,30,97
5889,21,28,20,26,95
5890,23,35,30,19,107
5891,34,27,24,18,103
5892,24,30,20,24,98
5893,24,33,22,38,117
5894,29,20,15,18,82
5895,24,24,31,21,100
5896,32,20,28,28,108
5897,18,31,25,25,99
5898,34,30,27,26,117
5899,21,21,22,29,93
5900,27,27,13,23,90
5901,19,29,28,28,104
5902,34,32,18,25,109
5903,22,38,21,21,102
5904,28,29,22,23,102
5905,27,21,24,21,93
5906,30,34,31,23,118
5907,19,26,25,36,106
5908,22,31,22,25,100
5909,19,24,33,21,97
5910,20,22,25,19,86
5911,30,28,24,30,112
5912,21,24,17,35,97
5913,32,22,23,18,95
5914,34,24,32,26,116
5915,25,20,21,28,94
5916,32,28,20,23,103
5917,32,29,19,18,98
5918,27,29,23,26,105
5919,19,29,24,22,94
5920,22,28,29,26,105
5921,19,33,19,33,104
5922,29,30,19,24,102
5923,21,37,25,22,105
5924,25,30,17,12,84
5925,29,20,13,26,88
5926,23,27,25,21,96
5927,24,23,18,27,92
5928,20,25,26,23,94
5929,28,32,23,23,106
5930,27,24,25,25,101
5931,27,29,17,17,90
5932,29,28,23,26,106
5933,27,29,26,26,108
5934,23,32,22,17,94
5935,24,23,25,18,90
5936,24,27,21,22,94
5937,16,23,19,22,80
5938,22,34,32,27,115
5939,24,27,24,28,103
5940,33,30,24,32,119
5941,25,33,25,24,107
5942,17,30,16,29,92
5943,14,28,17,26,85
5944,26,26,25,30,107
5945,25,20,20,30,95
5946,23,32,20,27,102
5947,22,22,23,31,98
5948,26,22,15,30,93
5949,30,22,29,23,104
5950,34,34,25,25,118
5951,19,30,30,24,103
5952,30,35,21,34,120
5953,30,28,21,28,107
5954,29,33,29,15,106
5955,17,27,21,21,86
5956,27,27,25,21,100
5957,23,33,27,19,102
5958,30,29,26,26,111
5959,21,22,21,34,98
5960,21,29,27,23,100
5961,28,36,17,21,102
5962,33,29,30,16,108
5963,35,24,26,22,107
5964,22,36,26,16,100
5965,36,33,24,33,126
5966,27,28,21,21,97
5967,17,32,29,22,100
5968,24,29,22,27,102
5969,23,33,20,19,95
5970,18,24,31,29,102
5971,22,30,23,27,102
5972,24,26,26,24,100
5973,28,28,20,19,95
5974,22,21,16,28,87
5975,20,28,20,25,93
5976,32,28,21,32,113
5977,22,28,18,15,83
5978,28,24,24,25,101
5979,27,29,27,31,114
5980,25,35,25,24,109
5981,30,23,26,28,107
5982,26,25,27,35,113
5983,24,31,25,28,108
5984,32,23,23,28,106
5985,21,25,17,28,91
5986,31,26,32,25,114
5987,31,25,22,30,108
5988,26,26,13,28,93
5989,16,26,23,30,95
5990,32,19,19,26,96
5991,23,25,18,21,87
5992,18,28,27,31,104
5993,34,26,27,31,118
5994,29,30,32,33,124
5995,27,30,30,25,112
5996,20,27,15,28,90
5997,28,31,20,24,103
5998,27,25,23,26,101
5999,29,20,32,23,104
6000,20,25,18,17,80
6001,26,27,25,28,106
6002,15,29,31,28,103
6003,23,25,23,21,92
6004,27,37,26,23,113
6005,25,35,12,27,99
6006,23,25,30,18,96
6007,28,26,27,34,115
6008,28,27,23,24,102
6009,27,26,23,26,102
6010,35,29,26,24,114
6011,15,26,22,24,87
6012,20,24,17,19,80
6013,21,26,21,21,89
6014,34,22,19,30,105
6015,28,28,26,36,118
6016,22,20,29,28,99
6017,23,29,24,30,106
6018,33,24,32,26,115
6019,21,22,26,22,91
6020,18,19,21,31,89
6021,33,25,20,30,108
6022,20,26,26,21,93
6023,19,29,20,16,84
6024,24,26,22,23,95
6025,23,31,16,29,99
6026,20,28,23,16,87
6027,29,28,25,27,109
6028,16,26,16,22,80
6029,25,27,17,27,96
6030,28,28,30,23,109
6031,29,25,16,21,91
6032,26,29,26,23,104
6033,36,25,25,21,107
6034,22,27,28,22,99
6035,17,22,16,16,71
6036,27,30,30,21,108
6037,29,41,23,27,120
6038,22,27,21,24,94
6039,28,23,26,21,98
6040,29,29,20,28,106
6041,19,22,22,31,94
6042,17,28,22,24,91
6043,22,36,18,22,98
6044,31,19,14,21,85
6045,26,25,21,28,100
6046,26,35,29,26,116
6047,32,26,21,19,98
6048,16,21,28,23,88
6049,20,37,23,25,105
6050,17,29,23,24,93
6051,25,28,25,27,105
6052,20,25,22,13,80
6053,30,27,29,24,110
6054,24,26,20,18,88
6055,15,28,20,33,96
6056,23,31,23,16,93
6057,15,37,23,27,102
6058,32,28,25,26,111
6059,24,26,21,22,93
6060,15,24,27,24,90
6061,20,31,20,26,97
6062,29,20,24,29,102
6063,22,30,26,32,110
6064,19,18,23,20,80
6065,19,30,29,18,96
6066,42,29,25,25,121
6067,20,30,28,30,108
6068,24,21,17,27,89
6069,24,35,22,21,102
6070,28,28,21,25,102
6071,29,31,31,16,107
6072,14,36,17,31,98
6073,29,36,20,27,112
6074,34,24,25,20,103
6075,26,28,35,29,118
6076,28,31,27,24,110
6077,26,27,27,25,105
6078,26,46,29,32,133
6079,16,19,21,20,76
6080,29,24,23,33,109
6081,18,28,18,28,92
6082,26,27,26,20,99
6083,18,25,22,19,84
6084,29,28,27,22,106
6085,23,28,21,20,92
6086,25,33,30,30,118
6087,27,26,23,22,98
6088,20,25,27,27,99
6089,26,25,28,22,101
6090,31,32,21,25,109
6091,30,24,22,28,104
6092,27,22,27,32,108
6093,26,26,25,28,105
6094,27,28,26,15,96
6095,28,24,25,31,108
6096,34,28,35,28,125
6097,23,25,16,21,85
6098,19,33,21,17,90
6099,20,20,21,28,89
6100,29,27,20,28,104
6101,26,31,28,22,107
6102,26,18,18,14,76
6103,20,31,23,25,99
6104,22,28,18,24,92
6105,17,23,24,21,85
6106,26,23,28,23,100
6107,24,26,19,17,86
6108,31,18,18,18,85
6109,21,32,21,22,96
6110,35,28,31,23,117
6111,24,33,26,20,103
6112,24,25,29,20,98
6113,22,22,35,31,110
6114,22,20,20,31,93
6115,27,26,21,17,91
6116,23,24,20,32,99
6117,23,29,20,26,98
6118,26,33,29,18,106
6119,23,20,29,18,90
6120,24,32,27,26,109
6121,25,31,22,26,104
6122,24,19,25,26,94
6123,22,31,20,24,97
6124,23,35,26,22,106
6125,26,22,20,35,103
6126,18,37,21,22,98
6127,26,27,20,21,94
6128,29,30,28,28,115
6129,26,27,20,37,110
6130,26,27,19,28,100
6131,26,25,19,22,92
6132,23,29,24,15,91
6133,31,31,17,24,103
6134,25,28,17,13,83
6135,20,26,29,23,98
6136,23,24,21,22,90
6137,23,42,25,32,122
6138,18,23,32,32,105
6139,24,35,33,25,117
6140,22,28,28,27,105
6141,32,25,20,14,91
6142,27,24,23,18,92
6143,27,26,35,22,110
6144,24,26,18,30,98
6145,23,35,18,24,100
6146,25,24,29,21,99
6147,27,28,23,25,103
6148,19,24,28,20,91
6149,24,28,20,19,91
6150,31,24,28,23,106
6151,26,22,19,21,88
6152,18,23,25,26,92
6153,26,25,18,15,84
6154,24,34,25,30,113
6155,22,27,28,23,100
6156,34,30,22,37,123
6157,30,27,24,26,107
6158,23,32,22,42,119
6159,30,29,27,15,101
6160,23,25,17,26,91
6161,19,32,31,22,104
6162,20,22,21,27,90
6163,16,34,25,21,96
6164,15,26,24,26,91
6165,19,27,25,19,90
6166,23,24,29,23,99
6167,24,24,21,24,93
6168,17,38,27,28,110
6169,32,31,22,28,113
6170,23,26,19,24,92
6171,27,23,23,23,96
6172,13,28,22,25,88
6173,23,33,30,26,112
6174,34,30,25,20,109
6175,24,22,32,20,98
6176,22,26,27,30,105
6177,26,26,24,26,102
6178,24,30,16,20,90
6179,26,29,26,24,105
6180,35,27,28,25,115
6181,29,30,22,18,99
6182,23,33,16,25,97
6183,24,25,27,28,104
6184,21,25,26,28,100
6185,23,23,16,26,88
6186,20,23,21,20,84
6187,34,21,28,36,119
6188,27,19,24,23,93
6189,29,22,24,25,100
6190,19,30,22,20,91
6191,24,26,30,29,109
6192,23,26,29,20,98
6193,21,22,28,28,99
6194,28,27,20,20,95
6195,26,24,28,20,98
6196,23,27,19,19,88
6197,21,25,22,22,90
6198,27,23,18,26,94
6199,25,29,25,25,104
6200,21,21,24,27,93
6201,29,22,19,23,93
6202,25,29,22,19,95
6203,24,29,25,21,99
6204,25,22,25,24,96
6205,21,30,27,25,103
6206,31,20,23,20,94
6207,29,30,22,22,103
6208,21,23,23,19,86
6209,16,32,24,21,93
6210,18,26,24,27,95
6211,21,27,29,19,96
6212,28,27,21,27,103
6213,25,24,15,36,100
6214,24,32,30,16,102
6215,31,28,14,27,100
6216,17,33,24,32,106
6217,22,31,21,21,95
6218,30,25,27,20,102
6219,26,28,31,25,110
6220,23,23,20,20,86
6221,25,30,25,29,109
6222,26,31,25,34,116
6223,18,29,31,29,107
6224,24,37,23,26,110
6225,24,26,18,26,94
6226,26,29,19,22,96
6227,29,28,32,20,109
6228,26,29,26,20,101
6229,33,22,25,28,108
6230,22,31,28,27,108
6231,23,30,18,29,100
6232,26,29,26,23,104
6233,23,25,34,29,111
6234,25,30,24,23,102
6235,38,29,19,25,111
6236,25,14,15,30,84
6237,29,25,18,19,91
6238,26,32,26,22,106
6239,26,21,22,23,92
6240,17,30,25,29,101
6241,29,21,24,27,101
6242,33,18,23,18,92
6243,25,29,22,24,100
6244,28,25,18,16,87
6245,18,31,24,24,97
6246,29,24,14,26,93
6247,23,35,26,23,107
6248,25,40,30,34,129
6249,21,44,30,29,124
6250,26,33,35,20,114
6251,24,21,25,26,96
6252,20,24,28,20,92
6253,23,37,30,30,120
6254,24,29,29,27,109
6255,21,24,26,28,99
6256,26,26,27,23,102
6257,34,22,24,26,106
6258,26,42,19,33,120
6259,19,28,27,31,105
6260,18,21,16,29,84
6261,31,34,22,24,111
6262,29,24,24,24,101
6263,21,27,20,18,86
6264,28,28,15,21,92
6265,21,31,25,26,103
6266,21,28,22,33,104
6267,24,28,27,15,94
6268,19,23,17,27,86
6269,18,27,25,16,86
6270,28,26,15,26,95
6271,22,32,19,26,99
6272,25,19,31,14,89
6273,28,28,30,30,116
6274,34,22,32,22,110
6275,20,24,24,22,90
6276,33,31,23,27,114
6277,18,26,25,23,92
6278,33,30,22,21,106
6279,21,21,24,28,94
6280,25,28,17,29,99
6281,16,27,29,22,94
6282,36,34,23,19,112
6283,18,18,19,23,78
6284,25,24,30,34,113
6285,19,37,26,32,114
6286,30,20,33,22,105
6287,34,30,19,27,110
6288,33,32,24,24,113
6289,20,26,27,29,102
6290,21,29,29,21,100
6291,23,37,23,21,104
6292,27,33,24,23,107
6293,20,25,28,16,89
6294,22,35,18,25,100
6295,21,31,19,32,103
6296,20,28,25,29,102
6297,21,27,21,24,93
6298,23,39,20,29,111
6299,31,36,31,20,118
6300,20,36,21,26,103
6301,26,35,23,25,109
6302,31,28,22,17,98
6303,25,25,15,28,93
6304,27,29,20,20,96
6305,28,33,18,21,100
6306,21,29,25,33,108
6307,24,39,20,27,110
6308,25,27,25,20,97
6309,18,24,25,18,85
6310,21,23,27,24,95
6311,23,34,28,24,109
6312,29,33,26,34,122
6313,30,29,18,22,99
6314,28,19,23,27,97
6315,25,31,29,16,101
6316,21,35,18,26,100
6317,22,26,16,20,84
6318,25,24,21,35,105
6319,33,34,30,30,127
6320,25,27,28,20,100
6321,28,32,24,27,111
6322,31,27,27,25,110
6323,23,28,24,20,95
6324,18,30,18,28,94
6325,14,33,22,22,91
6326,34,34,18,28,114
6327,25,25,31,29,110
6328,23,29,15,21,88
6329,23,25,19,24,91
6330,20,26,29,29,104
6331,29,23,21,18,91
6332,33,33,30,25,121
6333,27,27,22,16,92
6334,16,38,23,20,97
6335,30,26,29,29,114
6336,30,24,22,18,94
6337,20,29,27,30,106
6338,28,26,25,29,108
6339,20,28,26,24,98
6340,21,32,26,15,94
6341,36,33,27,29,125
6342,25,25,34,31,115
6343,15,29,22,21,87
6344,32,24,26,16,98
6345,29,34,27,27,117
6346,19,23,17,30,89
6347,21,28,20,29,98
6348,21,29,22,31,103
6349,24,25,21,22,92
6350,26,26,20,23,95
6351,22,31,33,19,105
6352,18,23,24,29,94
6353,30,25,22,20,97
6354,25,36,18,33,112
6355,23,33,20,22,98
6356,25,20,27,24,96
6357,24,27,16,34,101
6358,24,35,22,29,110
6359,26,28,27,28,109
6360,33,26,27,29,115
6361,15,37,16,17,85
6362,27,27,17,25,96
6363,27,27,26,19,99
6364,19,28,24,18,89
6365,16,36,28,22,102
6366,24,28,27,25,104
6367,27,24,32,19,102
6368,27,27,30,26,110
6369,15,39,18,25,97
6370,29,24,25,22,100
6371,25,25,24,22,96
6372,27,22,24,17,90
6373,22,28,28,23,101
6374,35,24,23,28,110
6375,32,25,24,26,107
6376,27,30,17,21,95
6377,28,31,33,22,114
6378,30,32,17,26,105
6379,25,26,22,24,97
6380,25,25,18,27,95
6381,29,35,30,30,124
6382,17,31,19,19,86
6383,26,25,29,19,99
6384,33,30,28,19,110
6385,20,25,20,29,94
6386,23,24,18,30,95
6387,22,27,21,30,100
6388,22,25,27,28,102
6389,25,28,27,27,107
6390,24,32,20,30,106
6391,25,29,18,20,92
6392,21,25,31,33,110
6393,21,24,23,28,96
6394,19,20,34,19,92
6395,25,26,28,36,115
6396,21,27,20,30,98
6397,30,25,26,23,104
6398,25,31,27,19,102
6399,27,23,23,26,99
6400,34,28,17,30,109
6401,20,21,27,23,91
6402,28,23,28,23,102
6403,23,23,20,23,89
6404,21,21,23,23,88
6405,21,24,36,20,101
6406,24,17,25,21,87
6407,20,28,18,20,86
6408,25,30,29,28,112
6409,19,20,26,27,92
6410,19,33,33,18,103
6411,21,32,19,23,95
6412,23,32,24,22,101
6413,32,32,23,34,121
6414,24,19,26,23,92
6415,26,31,20,21,98
6416,24,26,23,30,103
6417,23,39,22,19,103
6418,20,22,27,29,98
6419,29,25,21,26,101
6420,27,31,15,28,101
6421,16,19,21,20,76
6422,26,22,21,20,89
6423,26,23,25,26,100
6424,22,26,28,23,99
6425,24,36,25,28,113
6426,31,31,27,31,120
6427,28,21,29,32,110
6428,23,25,18,29,95
6429,21,21,22,25,89
6430,25,26,14,33,98
6431,27,42,26,22,117
6432,25,26,31,23,105
6433,19,30,12,25,86
6434,23,26,26,22,97
6435,23,27,15,18,83
6436,21,21,24,28,94
6437,24,26,20,22,92
6438,21,28,21,21,91
6439,28,26,31,28,113
6440,29,18,24,22,93
6441,28,16,24,20,88
6442,27,26,22,21,96
6443,21,24,31,23,99
6444,20,33,24,32,109
6445,22,26,17,23,88
6446,21,26,22,25,94
6447,22,37,26,28,113
6448,18,25,20,26,89
6449,24,23,34,28,109
6450,25,23,23,20,91
6451,19,31,27,27,104
6452,21,33,18,19,91
6453,35,24,13,29,101
6454,20,34,22,17,93
6455,18,29,14,24,85
6456,27,29,30,27,113
6457,17,23,21,21,82
6458,29,28,29,24,110
6459,31,19,19,16,85
6460,35,30,18,32,115
6461,21,31,21,24,97
6462,40,33,15,34,122
6463,17,21,18,23,79
6464,16,32,21,22,91
6465,29,26,29,21,105
6466,22,27,23,30,102
6467,25,32,18,17,92
6468,24,19,18,16,77
6469,21,28,28,27,104
6470,27,30,24,19,100
6471,20,25,18,23,86
6472,22,22,21,21,86
6473,20,28,29,31,108
6474,32,27,34,22,115
6475,31,25,23,16,95
6476,17,30,19,25,91
6477,19,34,22,20,95
6478,27,26,18,26,97
6479,26,30,29,34,119
6480,26,33,17,23,99
6481,27,22,21,15,85
6482,24,40,23,29,116
6483,29,26,18,25,98
6484,17,32,20,24,93
6485,26,31,23,22,102
6486,22,32,22,25,101
6487,24,22,27,21,94
6488,23,30,21,15,89
6489,23,20,18,24,85
6490,17,26,27,31,101
6491,30,34,26,23,113
6492,24,22,20,18,84
6493,22,32,25,19,98
6494,24,27,16,28,95
6495,24,31,24,20,99
6496,28,31,28,20,107
6497,26,23,18,18,85
6498,29,26,24,22,101
6499,25,32,28,25,110
6500,30,35,27,18,110
6501,28,24,18,25,95
6502,22,27,17,22,88
6503,18,25,24,29,96
6504,33,29,24,26,112
6505,22,24,33,20,99
6506,23,21,24,22,90
6507,21,25,23,22,91
6508,23,37,23,29,112
6509,28,41,20,28,117
6510,28,20,31,25,104
6511,25,22,22,19,88
6512,16,26,22,19,83
6513,26,29,20,27,102
6514,27,25,26,20,98
6515,29,27,27,19,102
6516,21,31,26,19,97
6517,24,26,19,21,90
6518,24,29,23,18,94
6519,29,23,25,27,104
6520,26,31,23,25,105
6521,16,19,21,23,79
6522,31,25,21,21,98
6523,20,25,23,25,93
6524,30,24,19,30,103
6525,30,22,28,22,102
6526,33,26,28,24,111
6527,24,26,19,21,90
6528,22,26,21,23,92
6529,27,25,21,27,100
6530,31,33,29,35,128
6531,25,20,31,32,108
6532,21,36,20,27,104
6533,28,28,22,34,112
6534,22,26,26,20,94
6535,23,21,19,28,91
6536,29,24,18,28,99
6537,21,34,22,30,107
6538,20,30,31,29,110
6539,21,21,19,28,89
6540,26,31,19,25,101
6541,22,23,29,25,99
6542,30,30,16,17,93
6543,34,17,19,19,89
6544,27,34,14,27,102
6545,21,27,32,24,104
6546,29,25,27,17,98
6547,21,25,24,39,109
6548,15,34,29,31,109
6549,31,32,32,18,113
6550,29,27,27,24,107
6551,22,25,26,24,97
6552,18,19,20,19,76
6553,22,27,28,25,102
6554,26,28,19,38,111
6555,23,29,21,24,97
6556,27,20,19,35,101
6557,16,20,20,29,85
6558,16,16,25,24,81
6559,28,35,22,26,111
6560,22,30,24,17,93
6561,18,20,19,25,82
6562,23,20,14,27,84
6563,23,23,28,27,101
6564,19,26,18,22,85
6565,24,32,22,31,109
6566,22,36,31,23,112
6567,25,33,15,24,97
6568,11,24,24,23,82
6569,25,26,23,23,97
6570,16,30,31,31,108
6571,28,21,17,17,83
6572,22,26,16,19,83
6573,23,29,17,19,88
6574,18,23,22,33,96
6575,25,23,16,13,77
6576,28,32,22,17,99
6577,21,31,20,22,94
6578,24,29,22,16,91
6579,18,26,37,26,107
6580,11,28,20,25,84
6581,23,25,27,20,95
6582,22,28,27,25,102
6583,23,29,22,21,95
6584,27,29,24,31,111
6585,18,37,34,23,112
6586,27,25,34,29,115
6587,20,27,25,23,95
6588,21,28,21,21,91
6589,35,26,29,26,116
6590,27,25,29,22,103
6591,28,18,25,29,100
6592,24,26,14,22,86
6593,32,28,18,17,95
6594,19,27,24,22,92
6595,29,30,26,25,110
6596,20,30,31,20,101
6597,25,32,20,18,95
6598,26,26,21,20,93
6599,19,31,23,24,97
6600,26,21,16,21,84
6601,24,28,31,26,109
6602,29,23,26,22,100
6603,16,21,19,32,88
6604,33,32,25,25,115
6605,31,30,20,32,113
6606,29,21,21,25,96
6607,20,34,31,21,106
6608,27,26,20,20,93
6609,23,34,23,29,109
6610,19,29,28,26,102
6611,32,21,25,25,103
6612,32,22,22,21,97
6613,23,23,21,22,89
6614,15,25,19,30,89
6615,25,27,20,35,107
6616,28,28,18,24,98
6617,34,38,18,22,112
6618,25,25,15,26,91
6619,26,19,27,16,88
6620,18,23,21,25,87
6621,30,34,25,28,117
6622,19,26,29,28,102
6623,25,29,23,28,105
6624,20,32,29,21,102
6625,14,27,21,17,79
6626,40,21,20,15,96
6627,23,29,14,24,90
6628,25,17,24,14,80
6629,27,27,15,25,94
6630,26,38,26,20,110
6631,21,20,18,17,76
6632,20,25,30,24,99
6633,13,33,26,27,99
6634,26,33,23,24,106
6635,17,27,25,27,96
6636,24,24,20,23,91
6637,15,36,22,18,91
6638,27,34,26,31,118
6639,24,29,20,17,90
6640,31,34,23,28,116
6641,24,26,27,25,102
6642,30,28,20,27,105
6643,27,32,26,28,113
6644,22,21,25,23,91
6645,22,24,20,24,90
6646,27,28,21,31,107
6647,21,26,22,31,100
6648,23,26,22,21,92
6649,31,17,23,25,96
6650,18,28,22,22,90
6651,21,23,23,28,95
6652,28,28,24,20,100
6653,28,29,23,22,102
6654,22,21,20,21,84
6655,22,24,24,31,101
6656,24,26,22,15,87
6657,16,28,27,32,103
6658,27,25,23,18,93
6659,26,29,23,32,110
6660,29,25,21,22,97
6661,34,30,27,28,119
6662,17,28,22,22,89
6663,19,26,20,28,93
6664,27,37,17,25,106
6665,30,26,20,29,105
6666,17,25,23,22,87
6667,23,26,25,16,90
6668,26,28,23,30,107
6669,22,28,24,25,99
6670,34,23,20,18,95
6671,21,27,20,27,95
6672,22,27,23,19,91
6673,19,21,24,27,91
6674,23,27,19,33,102
6675,21,23,15,29,88
6676,21,26,23,25,95
6677,27,21,18,19,85
6678,23,27,23,29,102
6679,20,29,26,16,91
6680,21,35,23,23,102
6681,22,31,25,21,99
6682,27,34,18,22,101
6683,26,18,23,22,89
6684,17,24,26,29,96
6685,28,27,19,22,96
6686,20,23,22,18,83
6687,24,24,27,36,111
6688,22,28,27,25,102
6689,29,21,24,24,98
6690,23,31,24,30,108
6691,25,25,26,35,111
6692,25,24,23,17,89
6693,21,21,21,26,89
6694,20,23,19,23,85
6695,31,27,17,24,99
6696,19,23,25,20,87
6697,17,28,25,26,96
6698,18,29,25,23,95
6699,32,24,26,26,108
6700,21,25,26,22,94
6701,30,30,20,28,108
6702,23,28,18,24,93
6703,23,26,20,36,105
6704,28,27,20,29,104
6705,27,36,17,26,106
6706,28,27,16,23,94
6707,36,28,25,23,112
6708,29,33,16,22,100
6709,25,28,29,25,107
6710,29,21,26,25,101
6711,15,32,25,26,98
6712,31,15,23,18,87
6713,24,33,17,29,103
6714,25,28,25,21,99
6715,25,23,27,26,101
6716,26,26,22,17,91
6717,23,39,26,28,116
6718,19,24,28,22,93
6719,25,24,13,24,86
6720,18,30,15,23,86
6721,24,26,19,23,92
6722,22,31,26,28,107
6723,19,34,33,26,112
6724,29,29,28,19,105
6725,36,27,28,30,121
6726,25,31,18,21,95
6727,27,24,17,17,85
6728,25,26,29,30,110
6729,36,34,24,26,120
6730,33,22,28,19,102
6731,27,27,20,30,104
6732,24,30,21,24,99
6733,19,24,26,27,96
6734,22,17,21,23,83
6735,27,22,14,22,85
6736,22,18,15,21,76
6737,27,29,29,27,112
6738,23,32,18,21,94
6739,25,32,26,31,114
6740,22,30,23,26,101
6741,23,28,29,15,95
6742,21,30,19,24,94
6743,21,23,18,18,80
6744,27,36,23,19,105
6745,21,31,28,30,110
6746,23,31,18,15,87
6747,19,27,27,29,102
6748,30,27,28,30,115
6749,26,33,22,24,105
6750,24,21,25,19,89
6751,24,34,20,21,99
6752,21,26,25,18,90
6753,26,33,22,21,102
6754,20,20,24,20,84
6755,27,27,20,25,99
6756,27,28,23,26,104
6757,24,21,22,28,95
6758,26,32,26,26,110
6759,26,23,22,23,94
6760,21,21,27,28,97
6761,28,24,23,26,101
6762,21,26,24,19,90
6763,21,31,15,32,99
6764,33,27,27,25,112
6765,15,18,22,18,73
6766,22,22,27,23,94
6767,23,27,27,25,102
6768,24,26,14,26,90
6769,26,23,29,25,103
6770,16,28,26,27,97
6771,24,25,15,23,87
6772,25,21,22,25,93
6773,17,29,17,23,86
6774,21,21,33,13,88
6775,20,25,21,21,87
6776,17,34,38,24,113
6777,27,26,17,18,88
6778,24,24,31,31,110
6779,24,34,20,23,101
6780,19,23,18,20,80
6781,32,33,19,30,114
6782,9,30,23,18,80
6783,29,18,25,25,97
6784,23,22,25,18,88
6785,21,41,22,25,109
6786,21,17,25,24,87
6787,26,26,17,20,89
6788,24,32,19,27,102
6789,22,23,16,21,82
6790,26,30,23,23,102
6791,31,27,23,23,104
6792,24,27,19,18,88
6793,21,23,24,26,94
6794,33,33,28,25,119
6795,21,23,36,32,112
6796,20,36,16,29,101
6797,24,30,22,21,97
6798,27,31,22,23,103
6799,30,28,22,32,112
6800,21,19,31,22,93
6801,24,29,27,29,109
6802,25,28,24,25,102
6803,31,32,22,23,108
6804,28,37,20,27,112
6805,24,26,22,19,91
6806,31,25,19,32,107
6807,19,28,23,22,92
6808,33,32,20,18,103
6809,27,23,19,35,104
6810,36,29,32,27,124
6811,21,33,21,29,104
6812,20,34,22,23,99
6813,20,27,28,21,96
6814,22,25,24,18,89
6815,28,27,24,24,103
6816,27,27,23,20,97
6817,30,29,15,18,92
6818,26,28,19,20,93
6819,27,26,13,31,97
6820,14,24,13,28,79
6821,24,36,23,20,103
6822,23,28,24,24,99
6823,24,29,24,23,100
6824,21,35,18,37,111
6825,22,30,29,20,101
6826,19,27,8,32,86
6827,20,24,28,20,92
6828,16,29,20,29,94
6829,21,19,24,20,84
6830,37,25,31,27,120
6831,21,28,27,22,98
6832,19,29,26,28,102
6833,19,25,13,23,80
6834,26,18,17,23,84
6835,31,34,25,25,115
6836,25,22,24,25,96
6837,16,21,15,24,76
6838,23,37,15,31,106
6839,29,21,24,20,94
6840,18,17,26,17,78
6841,23,28,20,21,92
6842,22,30,25,23,100
6843,29,37,13,29,108
6844,25,41,25,20,111
6845,19,24,26,27,96
6846,31,24,20,21,96
6847,22,21,26,24,93
6848,39,23,28,32,122
6849,22,29,21,21,93
6850,34,24,19,23,100
6851,19,30,28,24,101
6852,23,26,18,32,99
6853,23,28,19,34,104
6854,29,30,19,24,102
6855,22,23,21,27,93
6856,19,39,26,23,107
6857,26,24,20,23,93
6858,20,22,23,21,86
6859,24,28,33,32,117
6860,29,35,16,27,107
6861,31,28,19,28,106
6862,29,19,28,18,94
6863,23,23,17,24,87
6864,24,31,29,20,104
6865,26,26,28,39,119
6866,29,34,21,18,102
6867,27,27,27,19,100
6868,26,25,30,28,109
6869,28,20,24,25,97
6870,24,37,30,30,121
6871,23,39,19,29,110
6872,29,25,17,29,100
6873,24,26,24,16,90
6874,22,32,19,22,95
6875,21,24,17,20,82
6876,23,24,24,17,88
6877,26,22,19,22,89
6878,21,26,21,26,94
6879,28,24,29,19,100
6880,22,28,19,15,84
6881,20,24,19,17,80
6882,21,34,23,23,101
6883,26,31,27,32,116
6884,27,21,28,25,101
6885,26,20,17,29,92
6886,20,26,26,21,93
6887,27,29,21,22,99
6888,22,24,15,19,80
6889,21,34,19,24,98
6890,21,25,20,19,85
6891,30,25,21,27,103
6892,22,25,27,25,99
6893,14,30,20,20,84
6894,19,36,22,24,101
6895,25,29,30,26,110
6896,28,26,24,17,95
6897,29,30,17,29,105
6898,25,29,21,16,91
6899,21,25,17,27,90
6900,35,25,30,27,117
6901,26,28,26,35,115
6902,27,33,26,18,104
6903,27,30,39,23,119
6904,29,30,17,24,100
6905,24,22,24,26,96
6906,25,36,24,21,106
6907,30,26,22,30,108
6908,24,29,20,21,94
6909,29,21,26,32,108
6910,21,32,27,27,107
6911,24,34,24,30,112
6912,30,24,26,17,97
6913,27,24,25,28,104
6914,31,28,21,27,107
6915,23,28,23,25,99
6916,20,22,39,20,101
6917,20,26,27,26,99
6918,31,25,16,30,102
6919,26,29,27,20,102
6920,22,28,29,22,101
6921,33,20,18,32,103
6922,35,34,15,23,107
6923,22,24,20,31,97
6924,26,32,28,36,122
6925,19,27,21,24,91
6926,19,28,25,24,96
6927,24,23,35,24,106
6928,27,25,23,22,97
6929,25,20,23,24,92
6930,27,28,34,27,116
6931,18,20,26,20,84
6932,34,30,23,26,113
6933,27,26,29,22,104
6934,38,38,29,19,124
6935,25,28,23,28,104
6936,28,41,26,26,121
6937,14,22,30,27,93
6938,28,24,16,23,91
6939,30,30,20,32,112
6940,26,29,30,23,108
6941,19,22,20,18,79
6942,29,37,27,30,123
6943,17,34,19,30,100
6944,17,25,29,27,98
6945,31,22,26,26,105
6946,27,29,38,27,121
6947,20,24,31,19,94
6948,25,20,24,22,91
6949,18,27,21,24,90
6950,17,24,34,22,97
6951,29,27,24,21,101
6952,31,22,25,23,101
6953,35,24,23,21,103
6954,30,21,13,24,88
6955,24,24,12,21,81
6956,23,31,22,25,101
6957,31,28,31,27,117
6958,30,19,38,25,112
6959,24,27,26,18,95
6960,24,33,22,16,95
6961,25,29,21,22,97
6962,32,22,18,24,96
6963,17,24,18,25,84
6964,27,26,21,25,99
6965,22,30,19,17,88
6966,20,31,21,22,94
6967,31,25,26,16,98
6968,28,27,23,26,104
6969,16,21,29,26,92
6970,29,21,22,29,101
6971,25,32,28,25,110
6972,26,27,22,31,106
6973,25,34,23,24,106
6974,35,26,21,19,101
6975,20,31,30,27,108
6976,24,23,26,30,103
6977,37,27,23,28,115
6978,24,26,18,26,94
6979,29,45,30,24,128
6980,33,22,26,22,103
6981,26,29,17,28,100
6982,23,26,14,19,82
6983,20,28,26,21,95
6984,31,29,29,31,120
6985,18,24,23,27,92
6986,30,34,22,31,117
6987,25,33,28,19,105
6988,30,31,20,22,103
6989,28,26,31,14,99
6990,24,28,13,33,98
6991,28,39,36,20,123
6992,32,23,22,22,99
6993,23,33,33,23,112
6994,23,20,20,24,87
6995,26,25,21,23,95
6996,16,26,17,35,94
6997,25,24,23,29,101
6998,32,18,17,27,94
6999,21,18,21,23,83
7000,36,21,22,23,102
7001,24,30,24,33,111
7002,28,33,23,24,108
7003,27,23,22,20,92
7004,40,27,28,22,117
7005,26,31,26,32,115
7006,30,32,23,33,118
7007,31,35,23,21,110
7008,26,24,37,17,104
7009,25,26,26,27,104
7010,18,34,23,18,93
7011,28,22,25,18,93
7012,21,34,22,22,99
7013,26,38,25,30,119
7014,28,26,23,37,114
7015,20,21,22,26,89
7016,25,22,19,19,85
7017,22,24,21,24,91
7018,27,17,21,30,95
7019,26,22,20,26,94
7020,29,27,25,22,103
7021,29,24,23,27,103
7022,26,19,20,23,88
7023,20,23,17,24,84
7024,20,21,29,17,87
7025,21,26,19,26,92
7026,20,25,28,22,95
7027,29,31,20,23,103
7028,24,14,23,24,85
7029,29,21,17,26,93
7030,20,24,33,25,102
7031,19,24,30,39,112
7032,20,26,16,24,86
7033,20,30,28,32,110
7034,20,29,24,22,95
7035,22,27,25,18,92
7036,26,33,17,30,106
7037,22,30,29,25,106
7038,17,21,29,22,89
7039,22,30,23,24,99
7040,28,35,27,31,121
7041,31,33,21,29,114
7042,22,30,30,28,110
7043,17,25,16,18,76
7044,14,26,22,33,95
7045,26,38,18,27,109
7046,27,19,26,29,101
7047,27,29,27,23,106
7048,19,25,20,31,95
7049,25,30,25,27,107
7050,31,20,17,24,92
7051,21,26,17,21,85
7052,32,35,25,20,112
7053,29,34,30,31,124
7054,24,28,20,16,88
7055,26,25,23,29,103
7056,29,37,21,25,112
7057,22,22,18,23,85
7058,26,27,30,25,108
7059,17,37,20,21,95
7060,21,40,25,24,110
7061,23,22,23,22,90
7062,23,22,21,27,93
7063,26,22,20,21,89
7064,23,25,28,29,105
7065,27,24,31,24,106
7066,31,35,23,22,111
7067,23,24,17,26,90
7068,21,25,29,20,95
7069,21,21,17,31,90
7070,22,20,18,20,80
7071,24,28,18,29,99
7072,29,30,17,36,112
7073,26,23,22,19,90
7074,25,28,24,23,100
7075,25,30,28,28,111
7076,32,25,15,22,94
7077,19,20,24,22,85
7078,20,33,23,27,103
7079,22,27,23,28,100
7080,19,32,27,13,91
7081,28,36,21,21,106
7082,30,28,26,34,118
7083,22,33,19,22,96
7084,25,29,30,32,116
7085,19,32,21,28,100
7086,28,27,27,26,108
7087,14,28,25,19,86
7088,20,21,30,26,97
7089,35,30,15,29,109
7090,32,27,28,31,118
7091,27,30,27,30,114
7092,16,25,17,26,84
7093,21,27,26,23,97
7094,30,20,21,23,94
7095,27,14,19,27,87
7096,17,35,21,15,88
7097,20,27,21,27,95
7098,25,24,14,26,89
7099,27,25,22,23,97
7100,29,18,22,15,84
7101,25,18,22,28,93
7102,22,30,28,27,107
7103,18,32,17,24,91
7104,27,29,24,27,107
7105,28,27,19,20,94
7106,22,27,20,17,86
7107,25,29,14,20,88
7108,29,24,28,26,107
7109,21,29,18,24,92
7110,30,25,28,25,108
7111,24,24,15,26,89
7112,35,40,21,18,114
7113,17,26,25,24,92
7114,21,26,24,25,96
7115,24,27,24,23,98
7116,24,33,23,27,107
7117,29,31,32,15,107
7118,21,27,30,33,111
7119,31,30,20,24,105
7120,20,28,18,38,104
7121,29,31,20,25,105
7122,20,22,32,29,103
7123,29,29,28,21,107
7124,42,28,25,29,124
7125,26,28,15,19,88
7126,31,31,20,17,99
7127,24,25,28,23,100
7128,25,28,19,29,101
7129,26,24,26,28,104
7130,13,26,25,22,86
7131,23,24,28,20,95
7132,31,25,18,19,93
7133,17,29,27,27,100
7134,20,27,21,18,86
7135,23,16,25,28,92
7136,29,30,24,32,115
7137,26,23,19,23,91
7138,22,30,17,28,97
7139,26,24,23,25,98
7140,29,17,16,22,84
7141,17,32,24,23,96
7142,36,26,26,29,117
7143,21,31,23,32,107
7144,21,21,28,24,94
7145,20,20,19,20,79
7146,33,26,28,26,113
7147,18,23,29,22,92
7148,27,19,27,20,93
7149,27,23,20,20,90
7150,29,29,21,26,105
7151,25,20,21,20,86
7152,24,17,29,20,90
7153,19,37,29,29,114
7154,29,28,19,27,103
7155,29,30,26,23,108
7156,24,21,28,27,100
7157,33,27,17,29,106
7158,25,23,18,20,86
7159,31,32,24,22,109
7160,23,23,21,26,93
7161,17,27,29,28,101
7162,20,27,18,14,79
7163,19,31,17,26,93
7164,27,26,22,21,96
7165,14,26,17,25,82
7166,28,24,28,26,106
7167,27,31,23,24,105
7168,18,34,17,24,93
7169,26,19,25,29,99
7170,29,34,28,22,113
7171,23,25,26,21,95
7172,22,32,25,22,101
7173,31,26,22,24,103
7174,29,23,20,25,97
7175,23,27,20,31,101
7176,22,26,13,20,81
7177,28,26,25,21,100
7178,26,27,22,21,96
7179,30,32,35,23,120
7180,26,30,23,29,108
7181,26,24,24,22,96
7182,19,30,17,21,87
7183,41,24,26,21,112
7184,24,19,29,13,85
7185,25,18,28,25,96
7186,24,28,25,30,107
7187,33,21,28,20,102
7188,29,20,18,24,91
7189,23,22,24,29,98
7190,28,26,17,34,105
7191,17,26,31,15,89
7192,27,27,23,20,97
7193,17,31,20,18,86
7194,25,29,16,23,93
7195,26,37,20,25,108
7196,28,33,28,21,110
7197,18,26,30,23,97
7198,27,21,23,23,94
7199,25,30,22,23,100
7200,38,26,24,22,110
7201,17,25,25,30,97
7202,17,16,17,25,75
7203,32,22,17,20,91
7204,23,33,20,19,95
7205,22,28,24,28,102
7206,26,33,26,31,116
7207,29,22,24,20,95
7208,18,21,25,22,86
7209,15,21,19,21,76
7210,15,32,20,19,86
7211,23,28,36,17,104
7212,18,24,22,25,89
7213,21,24,22,22,89
7214,19,22,18,23,82
7215,20,34,20,27,101
7216,21,26,32,28,107
7217,21,33,24,28,106
7218,24,24,28,26,102
7219,16,18,28,26,88
7220,29,21,18,20,88
7221,25,41,22,20,108
7222,14,28,24,28,94
7223,20,29,26,25,100
7224,25,26,26,22,99
7225,21,20,20,35,96
7226,26,30,25,32,113
7227,24,29,21,19,93
7228,23,25,19,15,82
7229,27,18,20,29,94
7230,22,23,28,24,97
7231,27,22,22,29,100
7232,20,25,27,32,104
7233,28,32,32,30,122
7234,20,24,20,27,91
7235,19,27,27,24,97
7236,27,23,16,27,93
7237,26,26,26,20,98
7238,27,22,24,21,94
7239,28,26,21,26,101
7240,34,31,21,27,113
7241,26,24,25,28,103
7242,23,30,23,23,99
7243,23,34,28,26,111
7244,27,32,34,25,118
7245,34,30,22,21,107
7246,19,25,22,23,89
7247,14,18,28,19,79
7248,34,35,17,19,105
7249,30,35,22,22,109
7250,29,28,25,19,101
7251,24,28,19,30,101
7252,23,20,26,29,98
7253,30,35,20,24,109
7254,16,18,16,24,74
7255,29,30,24,19,102
7256,29,29,27,28,113
7257,27,38,19,29,113
7258,18,28,26,28,100
7259,18,26,20,27,91
7260,15,22,28,24,89
7261,33,24,19,36,112
7262,29,26,26,35,116
7263,29,24,25,27,105
7264,27,24,30,18,99
7265,25,26,28,46,125
7266,22,31,18,19,90
7267,15,28,21,25,89
7268,23,30,27,31,111
7269,25,29,26,32,112
7270,17,26,28,36,107
7271,24,32,24,18,98
7272,28,23,27,22,100
7273,18,26,18,23,85
7274,25,36,31,23,115
7275,33,28,19,21,101
7276,25,27,17,28,97
7277,22,28,35,25,110
7278,24,29,20,22,95
7279,16,27,23,15,81
7280,31,18,21,31,101
7281,38,24,27,31,120
7282,32,33,23,27,115
7283,19,28,28,26,101
7284,28,29,21,30,108
7285,34,30,29,20,113
7286,24,30,29,26,109
7287,28,25,34,26,113
7288,25,28,21,24,98
7289,14,29,35,22,100
7290,30,32,18,29,109
7291,31,28,24,27,110
7292,25,34,24,20,103
7293,27,21,21,20,89
7294,14,22,22,28,86
7295,32,32,16,30,110
7296,31,30,30,29,120
7297,24,28,24,29,105
7298,17,19,28,18,82
7299,21,29,21,22,93
7300,30,19,23,28,100
7301,18,27,21,29,95
7302,35,31,21,28,115
7303,19,27,25,28,99
7304,26,22,24,27,99
7305,23,28,31,28,110
7306,23,24,35,29,111
7307,30,26,20,30,106
7308,27,25,16,35,103
7309,31,23,27,29,110
7310,25,30,20,18,93
7311,16,23,17,11,67
7312,27,23,17,29,96
7313,17,19,19,13,68
7314,23,28,24,23,98
7315,21,27,28,21,97
7316,22,27,19,20,88
7317,26,30,31,29,116
7318,25,33,19,29,106
7319,25,26,19,19,89
7320,22,25,22,37,106
7321,34,33,26,26,119
7322,26,26,19,28,99
7323,14,26,16,16,72
7324,20,30,23,22,95
7325,25,24,17,26,92
7326,29,20,29,23,101
7327,34,31,26,24,115
7328,19,32,26,24,101
7329,25,29,21,25,100
7330,27,22,23,28,100
7331,20,24,35,21,100
7332,25,28,30,30,113
7333,16,27,21,27,91
7334,30,30,31,30,121
7335,16,22,17,22,77
7336,21,25,32,21,99
7337,19,26,24,28,97
7338,21,33,24,32,110
7339,21,36,24,21,102
7340,35,24,21,19,99
7341,29,20,33,23,105
7342,39,33,23,23,118
7343,20,29,16,25,90
7344,21,28,20,25,94
7345,20,30,21,22,93
7346,15,44,26,29,114
7347,20,29,26,25,100
7348,24,29,24,27,104
7349,25,21,24,17,87
7350,25,31,26,23,105
7351,23,32,29,24,108
7352,26,24,19,27,96
7353,28,28,31,23,110
7354,28,30,20,24,102
7355,29,32,16,22,99
7356,25,24,26,24,99
7357,30,16,21,12,79
7358,21,30,21,23,95
7359,23,23,23,34,103
7360,24,23,24,25,96
7361,31,31,27,23,112
7362,28,39,14,18,99
7363,21,31,31,20,103
7364,21,30,18,26,95
7365,22,23,21,21,87
7366,20,27,25,26,98
7367,21,20,27,25,93
7368,22,31,32,21,106
7369,26,25,22,26,99
7370,18,20,16,17,71
7371,26,30,18,28,102
7372,14,21,32,26,93
7373,33,27,25,23,108
7374,25,33,28,23,109
7375,30,29,29,28,116
7376,23,25,20,25,93
7377,18,28,26,34,106
7378,18,36,29,23,106
7379,17,30,22,31,100
7380,29,26,24,22,101
7381,23,36,30,31,120
7382,20,23,28,24,95
7383,25,24,23,26,98
7384,21,32,29,31,113
7385,26,25,26,28,105
7386,28,35,30,31,124
7387,23,26,27,17,93
7388,23,31,26,20,100
7389,29,28,18,26,101
7390,19,21,25,27,92
7391,25,31,20,20,96
7392,17,34,21,23,95
7393,21,25,20,21,87
7394,21,28,15,30,94
7395,14,20,29,34,97
7396,20,15,31,21,87
7397,31,32,27,28,118
7398,27,26,25,27,105
7399,25,33,12,17,87
7400,22,29,28,27,106
7401,15,33,18,26,92
7402,24,32,20,25,101
7403,20,31,23,23,97
7404,24,33,24,21,102
7405,27,25,24,25,101
7406,28,23,23,24,98
7407,21,24,18,24,87
7408,24,31,24,32,111
7409,19,26,29,32,106
7410,30,26,29,22,107
7411,26,20,26,27,99
7412,21,26,27,29,103
7413,24,22,22,33,101
7414,23,26,23,23,95
7415,18,24,22,14,78
7416,32,37,32,19,120
7417,28,19,14,24,85
7418,24,33,25,28,110
7419,25,27,22,26,100
7420,20,32,25,27,104
7421,28,31,33,28,120
7422,19,25,25,26,95
7423,22,29,21,31,103
7424,19,23,21,28,91
7425,21,24,30,29,104
7426,35,33,21,22,111
7427,16,30,25,22,93
7428,19,31,24,25,99
7429,30,31,26,20,107
7430,19,27,33,24,103
7431,15,26,15,25,81
7432,20,25,34,20,99
7433,22,36,24,25,107
7434,29,25,21,19,94
7435,24,24,25,23,96
7436,21,32,16,22,91
7437,30,31,16,30,107
7438,29,24,22,23,98
7439,22,27,27,30,106
7440,28,23,33,25,109
7441,20,27,29,29,105
7442,15,37,21,27,100
7443,30,28,28,29,115
7444,23,21,27,21,92
7445,17,25,26,26,94
7446,28,28,27,28,111
7447,25,23,27,29,104
7448,29,36,28,30,123
7449,22,22,25,15,84
7450,30,27,34,19,110
7451,23,25,23,23,94
7452,24,25,24,19,92
7453,26,29,18,24,97
7454,22,29,32,20,103
7455,15,21,30,21,87
7456,34,26,20,34,114
7457,27,27,21,29,104
7458,26,30,28,26,110
7459,22,24,25,27,98
7460,21,29,18,26,94
7461,22,21,20,32,95
7462,21,25,17,37,100
7463,19,29,21,22,91
7464,33,22,29,23,107
7465,23,27,17,21,88
7466,25,25,31,25,106
7467,19,30,22,18,89
7468,24,31,33,31,119
7469,24,24,26,18,92
7470,26,21,23,22,92
7471,28,26,20,25,99
7472,20,28,26,26,100
7473,22,29,23,27,101
7474,22,24,19,25,90
7475,30,20,22,30,102
7476,24,29,22,32,107
7477,20,27,20,29,96
7478,26,28,16,20,90
7479,14,21,20,24,79
7480,21,17,21,20,79
7481,30,24,22,24,100
7482,24,28,18,20,90
7483,18,20,22,27,87
7484,28,40,20,21,109
7485,29,25,24,18,96
7486,20,23,30,24,97
7487,17,26,25,25,93
7488,29,27,31,32,119
7489,21,28,28,24,101
7490,27,21,26,26,100
7491,21,24,27,23,95
7492,22,20,19,20,81
7493,21,26,28,26,101
7494,20,27,25,24,96
7495,33,25,22,23,103
7496,30,20,11,27,88
7497,24,27,24,22,97
7498,25,32,24,24,105
7499,30,22,20,31,103
7500,21,24,18,18,81
7501,32,26,24,16,98
7502,25,31,27,22,105
7503,19,22,20,23,84
7504,33,29,19,23,104
7505,22,34,12,31,99
7506,21,28,22,20,91
7507,31,27,24,19,101
7508,20,22,34,20,96
7509,21,27,28,22,98
7510,18,24,23,22,87
7511,27,29,18,30,104
7512,31,31,17,29,108
7513,22,26,23,29,100
7514,33,26,20,33,112
7515,25,24,21,19,89
7516,23,25,20,23,91
7517,20,18,26,19,83
7518,25,27,25,31,108
7519,25,28,22,21,96
7520,19,33,40,36,128
7521,20,32,20,34,106
7522,33,29,26,25,113
7523,28,25,28,26,107
7524,32,26,22,25,105
7525,32,26,32,23,113
7526,28,25,21,25,99
7527,28,25,34,24,111
7528,29,29,20,19,97
7529,25,29,24,22,100
7530,18,24,19,22,83
7531,25,23,24,19,91
7532,21,25,16,24,86
7533,24,25,20,20,89
7534,22,21,27,23,93
7535,31,30,25,28,114
7536,19,29,24,31,103
7537,25,34,25,20,104
7538,25,32,24,23,104
7539,25,28,25,26,104
7540,18,35,23,19,95
7541,18,23,14,23,78
7542,23,24,23,20,90
7543,29,29,29,28,115
7544,28,29,22,18,97
7545,18,28,23,29,98
7546,22,22,25,21,90
7547,21,23,29,21,94
7548,28,23,18,32,101
7549,32,26,24,23,105
7550,27,23,28,27,105
7551,26,30,33,25,114
7552,27,27,24,24,102
7553,25,33,17,28,103
7554,20,25,22,29,96
7555,39,30,19,25,113
7556,29,28,25,23,105
7557,24,25,21,20,90
7558,23,29,28,29,109
7559,30,26,22,25,103
7560,21,21,21,25,88
7561,21,28,31,21,101
7562,22,22,21,24,89
7563,33,23,25,14,95
7564,29,25,22,31,107
7565,16,25,28,21,90
7566,24,28,19,26,97
7567,24,28,20,35,107
7568,30,28,29,31,118
7569,31,22,24,23,100
7570,18,27,25,19,89
7571,23,24,26,22,95
7572,21,32,19,22,94
7573,28,29,26,31,114
7574,28,24,24,28,104
7575,20,29,26,32,107
7576,20,35,17,28,100
7577,24,29,26,28,107
7578,23,27,30,23,103
7579,25,25,26,29,105
7580,21,34,26,34,115
7581,26,24,27,24,101
7582,19,30,18,22,89
7583,21,27,27,23,98
7584,23,25,34,24,106
7585,20,22,16,18,76
7586,20,21,23,27,91
7587,21,23,30,23,97
7588,26,33,26,28,113
7589,22,26,27,26,101
7590,35,26,29,21,111
7591,28,34,13,31,106
7592,17,21,21,19,78
7593,29,26,15,24,94
7594,22,26,30,28,106
7595,22,27,27,23,99
7596,26,39,35,29,129
7597,22,28,25,30,105
7598,36,25,20,29,110
7599,18,30,23,22,93
7600,27,26,27,22,102
7601,21,21,19,18,79
7602,19,30,21,27,97
7603,23,32,24,22,101
7604,30,29,15,25,99
7605,24,25,17,26,92
7606,29,33,24,13,99
7607,23,25,12,24,84
7608,24,24,31,21,100
7609,23,24,22,27,96
7610,21,25,19,30,95
7611,27,25,24,27,103
7612,29,34,21,24,108
7613,35,20,24,17,96
7614,25,20,24,28,97
7615,21,30,26,24,101
7616,28,20,19,21,88
7617,22,34,24,17,97
7618,29,30,26,23,108
7619,22,21,29,23,95
7620,25,37,20,34,116
7621,25,25,24,25,99
7622,31,32,19,27,109
7623,23,25,19,39,106
7624,25,30,28,26,109
7625,22,30,19,33,104
7626,20,17,24,24,85
7627,28,31,18,27,104
7628,19,17,28,22,86
7629,23,29,21,29,102
7630,25,20,27,26,98
7631,30,27,26,23,106
7632,26,24,36,24,110
7633,28,31,26,21,106
7634,30,26,31,17,104
7635,20,23,21,13,77
7636,27,30,29,20,106
7637,25,31,34,28,118
7638,13,19,25,18,75
7639,23,32,31,19,105
7640,20,31,30,28,109
7641,35,25,31,22,113
7642,20,36,24,31,111
7643,25,24,24,26,99
7644,23,34,19,24,100
7645,28,32,16,32,108
7646,33,33,30,23,119
7647,20,23,16,21,80
7648,21,28,17,24,90
7649,24,23,18,16,81
7650,31,24,27,25,107
7651,27,24,25,19,95
7652,34,33,19,24,110
7653,32,33,23,27,115
7654,20,30,17,19,86
7655,24,27,23,25,99
7656,22,25,20,29,96
7657,27,27,23,27,104
7658,25,30,31,17,103
7659,21,23,15,16,75
7660,24,28,33,26,111
7661,27,23,33,21,104
7662,20,20,19,24,83
7663,35,25,24,30,114
7664,33,25,28,22,108
7665,24,34,21,20,99
7666,26,32,21,24,103
7667,21,30,30,29,110
7668,31,24,22,22,99
7669,26,25,10,21,82
7670,11,25,28,27,91
7671,32,28,20,34,114
7672,23,35,22,23,103
7673,20,27,22,24,93
7674,26,20,26,32,104
7675,25,26,28,22,101
7676,22,23,23,13,81
7677,12,32,28,31,103
7678,28,22,21,22,93
7679,17,26,12,27,82
7680,17,29,16,19,81
7681,20,29,21,27,97
7682,22,25,23,24,94
7683,28,28,29,27,112
7684,21,18,24,30,93
7685,24,30,16,18,88
7686,23,24,22,22,91
7687,30,30,27,26,113
7688,25,24,23,19,91
7689,38,26,19,21,104
7690,29,20,13,17,79
7691,21,26,15,28,90
7692,28,20,25,33,106
7693,33,23,22,17,95
7694,24,32,25,23,104
7695,25,28,29,21,103
7696,28,32,15,27,102
7697,26,31,29,34,120
7698,18,34,28,26,106
7699,29,27,32,24,112
7700,20,22,19,24,85
7701,29,34,23,29,115
7702,25,28,24,18,95
7703,27,24,25,26,102
7704,20,27,26,23,96
7705,28,21,24,25,98
7706,26,25,20,34,105
7707,21,30,23,25,99
7708,24,24,23,25,96
7709,23,32,34,24,113
7710,20,34,23,24,101
7711,23,25,24,18,90
7712,27,22,21,17,87
7713,36,27,25,33,121
7714,28,19,26,16,89
7715,25,21,20,27,93
7716,28,30,23,25,106
7717,23,31,27,21,102
7718,28,23,20,31,102
7719,29,21,31,15,96
7720,23,24,24,28,99
7721,19,36,26,29,110
7722,30,35,35,19,119
7723,26,32,21,16,95
7724,15,22,30,22,89
7725,24,23,31,31,109
7726,33,26,25,27,111
7727,25,26,31,25,107
7728,25,31,29,20,105
7729,31,34,22,26,113
7730,26,27,30,18,101
7731,21,21,27,17,86
7732,33,24,25,23,105
7733,20,25,16,25,86
7734,16,31,26,31,104
7735,22,32,27,31,112
7736,28,21,27,30,106
7737,20,34,27,24,105
7738,24,34,20,23,101
7739,27,22,19,26,94
7740,22,24,18,27,91
7741,19,26,26,15,86
7742,27,23,17,22,89
7743,35,33,20,22,110
7744,25,26,20,28,99
7745,16,18,35,24,93
7746,30,28,26,33,117
7747,25,34,20,18,97
7748,32,28,25,36,121
7749,22,31,23,27,103
7750,21,26,18,18,83
7751,16,38,23,31,108
7752,30,23,21,27,101
7753,27,28,27,26,108
7754,24,21,17,29,91
7755,28,31,16,29,104
7756,25,30,26,13,94
7757,20,34,23,31,108
7758,19,24,20,31,94
7759,24,31,15,23,93
7760,20,22,18,28,88
7761,26,26,19,28,99
7762,26,20,20,38,104
7763,27,32,23,23,105
7764,19,31,23,32,105
7765,25,28,22,17,92
7766,24,24,28,30,106
7767,25,33,24,28,110
7768,28,21,26,29,104
7769,17,25,22,24,88
7770,26,34,21,20,101
7771,18,22,31,18,89
7772,22,20,20,30,92
7773,16,15,20,13,64
7774,25,25,30,25,105
7775,27,33,25,24,109
7776,28,32,24,24,108
7777,18,22,26,23,89
7778,22,22,21,21,86
7779,22,25,24,20,91
7780,26,30,18,19,93
7781,22,27,22,27,98
7782,32,18,29,20,99
7783,28,26,24,16,94
7784,27,27,29,21,104
7785,26,37,30,23,116
7786,27,22,28,31,108
7787,24,29,30,18,101
7788,25,30,26,21,102
7789,30,29,22,26,107
7790,29,26,25,22,102
7791,25,35,23,29,112
7792,24,32,22,24,102
7793,22,38,33,17,110
7794,23,29,18,21,91
7795,30,26,19,22,97
7796,29,24,22,19,94
7797,27,31,28,30,116
7798,27,26,31,28,112
7799,19,25,27,35,106
7800,27,28,29,24,108
7801,20,27,25,18,90
7802,27,31,19,30,107
7803,29,38,20,25,112
7804,23,29,21,22,95
7805,20,34,19,25,98
7806,22,23,21,26,92
7807,22,23,21,25,91
7808,15,28,22,27,92
7809,23,32,23,29,107
7810,22,34,31,21,108
7811,25,25,22,27,99
7812,21,27,20,21,89
7813,32,26,28,29,115
7814,19,33,29,24,105
7815,20,30,23,24,97
7816,30,24,26,25,105
7817,35,22,33,30,120
7818,34,32,23,18,107
7819,23,30,19,23,95
7820,27,34,20,23,104
7821,26,23,18,18,85
7822,22,22,16,31,91
7823,38,32,26,24,120
7824,20,19,28,25,92
7825,23,23,22,30,98
7826,36,32,18,26,112
7827,30,32,21,21,104
7828,22,30,25,17,94
7829,30,24,20,19,93
7830,27,39,28,32,126
7831,32,26,30,28,116
7832,17,30,20,20,87
7833,22,20,33,24,99
7834,22,28,15,23,88
7835,34,31,25,33,123
7836,28,32,19,33,112
7837,27,25,20,32,104
7838,19,30,19,26,94
7839,28,30,22,23,103
7840,26,38,29,21,114
7841,32,30,30,13,105
7842,24,24,25,36,109
7843,24,35,32,26,117
7844,23,29,29,29,110
7845,28,33,24,22,107
7846,20,30,23,24,97
7847,29,30,25,34,118
7848,17,33,23,30,103
7849,27,22,28,26,103
7850,24,25,27,25,101
7851,22,29,26,22,99
7852,30,38,29,22,119
7853,24,22,21,26,93
7854,25,25,23,20,93
7855,20,26,24,26,96
7856,24,27,34,29,114
7857,23,31,22,20,96
7858,25,29,18,32,104
7859,30,36,36,26,128
7860,17,32,30,24,103
7861,26,28,24,26,104
7862,39,23,29,14,105
7863,25,35,19,27,106
7864,24,24,28,28,104
7865,21,28,12,24,85
7866,27,28,19,17,91
7867,19,22,27,24,92
7868,22,27,24,25,98
7869,35,33,33,24,125
7870,22,26,27,21,96
7871,30,31,30,24,115
7872,27,21,18,37,103
7873,21,32,32,26,111
7874,28,27,22,20,97
7875,27,31,18,31,107
7876,33,20,29,21,103
7877,24,32,25,20,101
7878,34,19,17,28,98
7879,26,28,31,30,115
7880,23,17,18,35,93
7881,29,29,22,23,103
7882,21,27,16,21,85
7883,32,23,20,21,96
7884,27,28,19,33,107
7885,22,24,23,23,92
7886,22,31,20,24,97
7887,28,25,21,17,91
7888,21,23,30,16,90
7889,23,29,27,25,104
7890,34,24,34,19,111
7891,24,29,25,29,107
7892,29,24,23,32,108
7893,23,32,24,26,105
7894,25,33,14,22,94
7895,19,34,17,29,99
7896,25,25,29,19,98
7897,27,33,23,16,99
7898,22,24,25,26,97
7899,27,23,27,32,109
7900,35,26,22,34,117
7901,17,25,20,18,80
7902,24,27,21,29,101
7903,28,28,25,37,118
7904,22,26,28,24,100
7905,25,30,17,22,94
7906,24,18,26,20,88
7907,28,28,15,9,80
7908,30,25,24,21,100
7909,18,30,22,20,90
7910,24,24,18,31,97
7911,21,25,33,24,103
7912,26,28,27,27,108
7913,26,28,20,25,99
7914,18,33,28,26,105
7915,28,32,26,34,120
7916,22,22,29,20,93
7917,20,22,23,20,85
7918,24,28,26,23,101
7919,16,25,28,27,96
7920,25,28,22,20,95
7921,21,21,23,24,89
7922,31,37,14,17,99
7923,27,37,33,18,115
7924,24,29,24,24,101
7925,24,26,17,28,95
7926,27,27,21,33,108
7927,25,26,22,14,87
7928,22,30,27,19,98
7929,17,33,23,19,92
7930,21,25,23,32,101
7931,19,18,31,28,96
7932,22,31,20,17,90
7933,21,21,17,27,86
7934,24,23,28,31,106
7935,28,32,28,17,105
7936,15,26,16,24,81
7937,26,31,22,23,102
7938,17,26,16,30,89
7939,24,32,29,24,109
7940,27,24,23,19,93
7941,27,37,21,19,104
7942,25,25,24,28,102
7943,23,19,24,26,92
7944,21,25,34,31,111
7945,20,19,14,16,69
7946,29,33,16,31,109
7947,20,25,17,23,85
7948,19,25,19,17,80
7949,24,20,26,24,94
7950,21,34,22,26,103
7951,25,24,30,15,94
7952,25,21,19,22,87
7953,24,25,26,25,100
7954,27,28,21,23,99
7955,21,30,27,23,101
7956,18,35,19,19,91
7957,27,38,27,21,113
7958,28,29,23,14,94
7959,28,31,24,15,98
7960,31,30,27,27,115
7961,26,26,22,26,100
7962,20,19,26,27,92
7963,26,29,20,26,101
7964,25,19,17,21,82
7965,22,20,18,21,81
7966,27,32,21,24,104
7967,17,25,30,25,97
7968,22,25,27,29,103
7969,36,30,23,16,105
7970,19,24,22,29,94
7971,22,26,20,27,95
7972,27,21,21,22,91
7973,20,23,24,21,88
7974,21,22,21,23,87
7975,21,33,21,31,106
7976,27,38,21,22,108
7977,28,24,22,22,96
7978,24,23,23,21,91
7979,20,24,30,24,98
7980,28,35,23,27,113
7981,18,29,22,21,90
7982,19,26,21,30,96
7983,31,22,26,29,108
7984,22,30,24,21,97
7985,22,26,27,18,93
7986,21,30,20,19,90
7987,21,23,19,16,79
7988,23,29,28,25,105
7989,33,34,20,26,113
7990,26,35,16,18,95
7991,28,26,32,23,109
7992,22,27,16,17,82
7993,16,22,24,17,79
7994,20,27,21,22,90
7995,26,25,28,18,97
7996,23,32,23,24,102
7997,29,24,31,21,105
7998,23,38,25,21,107
7999,16,30,28,22,96
8000,30,39,27,29,125
8001,26,22,25,19,92
8002,32,25,20,21,98
8003,28,27,22,21,98
8004,25,33,19,21,98
8005,23,31,23,20,97
8006,21,25,25,38,109
8007,28,22,18,21,89
8008,21,24,23,28,96
8009,25,28,32,16,101
8010,32,22,21,23,98
8011,26,25,22,30,103
8012,22,24,24,31,101
8013,30,28,17,17,92
8014,18,26,16,23,83
8015,19,18,25,19,81
8016,24,32,23,27,106
8017,27,30,26,27,110
8018,26,22,19,32,99
8019,25,22,26,24,97
8020,26,22,24,19,91
8021,30,28,26,25,109
8022,28,25,29,29,111
8023,29,28,19,28,104
8024,23,24,13,21,81
8025,26,29,22,25,102
8026,24,24,21,24,93
8027,39,27,30,17,113
8028,34,31,20,23,108
8029,23,26,14,31,94
8030,25,25,15,27,92
8031,21,27,27,16,91
8032,21,30,33,23,107
8033,21,25,25,29,100
8034,18,29,25,25,97
8035,23,25,24,31,103
8036,32,22,27,22,103
8037,13,36,18,28,95
8038,23,31,29,34,117
8039,20,23,22,27,92
8040,25,31,33,27,116
8041,24,32,24,20,100
8042,35,23,29,19,106
8043,28,21,27,31,107
8044,26,29,31,21,107
8045,25,28,35,22,110
8046,32,35,30,26,123
8047,27,27,24,24,102
8048,30,25,26,29,110
8049,25,15,21,32,93
8050,13,32,34,27,106
8051,27,26,24,28,105
8052,19,20,19,15,73
8053,29,37,22,23,111
8054,27,24,28,18,97
8055,22,23,25,28,98
8056,23,26,26,39,114
8057,17,31,20,27,95
8058,29,32,16,26,103
8059,27,28,30,25,110
8060,34,35,18,25,112
8061,20,21,17,20,78
8062,27,32,23,22,104
8063,31,26,22,33,112
8064,25,15,18,32,90
8065,22,22,17,22,83
8066,16,32,23,17,88
8067,23,28,24,23,98
8068,30,31,15,26,102
8069,26,24,14,24,88
8070,28,36,22,23,109
8071,22,28,27,30,107
8072,38,30,28,24,120
8073,19,19,30,39,107
8074,22,28,20,18,88
8075,22,26,21,26,95
8076,28,27,27,30,112
8077,25,33,24,21,103
8078,24,25,19,27,95
8079,27,25,23,34,109
8080,28,28,26,28,110
8081,21,33,17,27,98
8082,27,32,20,25,104
8083,22,35,14,24,95
8084,30,33,22,24,109
8085,26,21,21,25,93
8086,30,18,22,25,95
8087,28,24,24,26,102
8088,28,29,24,29,110
8089,23,25,32,17,97
8090,25,22,29,26,102
8091,30,19,28,27,104
8092,32,30,22,20,104
8093,27,21,34,21,103
8094,24,27,19,23,93
8095,23,34,27,22,106
8096,25,23,18,21,87
8097,19,25,22,24,90
8098,21,27,20,28,96
8099,27,26,20,31,104
8100,22,32,23,31,108
8101,21,21,24,24,90
8102,28,29,24,27,108
8103,25,28,21,24,98
8104,21,27,20,20,88
8105,31,30,23,30,114
8106,19,23,20,23,85
8107,34,27,22,30,113
8108,31,23,25,22,101
8109,28,29,19,20,96
8110,24,24,26,26,100
8111,20,28,24,34,106
8112,19,26,19,16,80
8113,27,30,25,24,106
8114,20,20,20,20,80
8115,25,22,23,30,100
8116,26,24,21,21,92
8117,22,35,25,22,104
8118,27,23,36,21,107
8119,22,25,24,23,94
8120,19,37,23,25,104
8121,24,18,27,19,88
8122,25,24,23,32,104
8123,28,35,21,19,103
8124,29,27,27,27,110
8125,18,34,27,34,113
8126,23,23,30,33,109
8127,16,25,24,27,92
8128,22,35,31,25,113
8129,28,25,20,27,100
8130,28,23,18,20,89
8131,28,29,24,29,110
8132,28,32,30,25,115
8133,22,24,11,24,81
8134,23,32,15,22,92
8135,24,31,21,18,94
8136,26,30,28,26,110
8137,21,27,21,28,97
8138,27,30,20,28,105
8139,26,24,22,15,87
8140,28,22,26,23,99
8141,25,30,26,23,104
8142,28,35,25,25,113
8143,31,32,23,30,116
8144,29,30,29,15,103
8145,30,28,25,21,104
8146,15,26,30,25,96
8147,33,29,24,22,108
8148,20,23,16,19,78
8149,12,27,28,29,96
8150,21,28,21,27,97
8151,25,30,26,18,99
8152,28,20,29,30,107
8153,23,31,23,16,93
8154,25,24,24,30,103
8155,21,37,18,20,96
8156,25,23,26,31,105
8157,32,26,18,23,99
8158,20,33,29,22,104
8159,32,28,28,30,118
8160,19,28,15,27,89
8161,27,24,24,29,104
8162,29,28,27,26,110
8163,16,33,20,31,100
8164,27,25,20,27,99
8165,20,26,29,23,98
8166,23,21,25,26,95
8167,24,27,23,20,94
8168,22,28,22,23,95
8169,25,26,23,22,96
8170,19,31,19,33,102
8171,23,26,25,30,104
8172,24,30,25,21,100
8173,21,37,25,21,104
8174,23,23,23,24,93
8175,26,26,18,23,93
8176,22,28,30,26,106
8177,27,18,25,31,101
8178,27,26,29,22,104
8179,18,31,21,25,95
8180,21,27,25,23,96
8181,29,33,24,27,113
8182,24,23,23,23,93
8183,22,21,17,24,84
8184,22,22,23,32,99
8185,24,31,30,28,113
8186,20,19,26,24,89
8187,24,31,20,27,102
8188,34,31,15,16,96
8189,14,21,13,27,75
8190,20,28,27,29,104
8191,25,19,16,28,88
8192,16,28,24,27,95
8193,21,18,24,18,81
8194,28,31,26,23,108
8195,22,43,30,33,128
8196,24,29,22,21,96
8197,22,25,31,24,102
8198,20,27,23,21,91
8199,24,32,21,22,99
8200,22,25,24,30,101
8201,31,34,20,23,108
8202,25,26,29,25,105
8203,23,24,22,25,94
8204,34,33,27,28,122
8205,26,32,20,24,102
8206,26,29,24,20,99
8207,23,29,24,24,100
8208,18,31,20,33,102
8209,30,37,24,23,114
8210,24,23,18,20,85
8211,25,23,25,25,98
8212,28,20,16,29,93
8213,28,33,32,23,116
8214,32,21,27,27,107
8215,22,30,22,22,96
8216,19,33,25,20,97
8217,23,30,26,23,102
8218,23,31,30,26,110
8219,27,24,18,30,99
8220,17,23,17,24,81
8221,26,35,29,26,116
8222,25,21,28,23,97
8223,22,27,21,15,85
8224,29,27,25,27,108
8225,22,21,24,22,89
8226,18,29,31,14,92
8227,25,24,24,28,101
8228,23,22,17,24,86
8229,25,27,23,27,102
8230,21,36,16,18,91
8231,26,31,26,23,106
8232,23,29,15,23,90
8233,28,23,19,35,105
8234,29,29,22,25,105
8235,26,34,27,16,103
8236,28,33,16,24,101
8237,27,19,15,28,89
8238,19,32,22,29,102
8239,23,27,22,22,94
8240,28,26,22,24,100
8241,35,26,17,19,97
8242,23,28,31,22,104
8243,17,29,31,23,100
8244,19,26,26,17,88
8245,24,30,28,27,109
8246,17,35,25,24,101
8247,19,21,26,25,91
8248,26,38,15,22,101
8249,28,27,27,31,113
8250,22,20,27,26,95
8251,29,25,22,24,100
8252,24,32,26,32,114
8253,21,22,24,33,100
8254,27,29,26,28,110
8255,20,30,24,25,99
8256,22,22,28,19,91
8257,26,33,25,30,114
8258,21,20,25,33,99
8259,20,29,24,20,93
8260,22,34,21,35,112
8261,15,19,23,23,80
8262,30,30,23,26,109
8263,27,24,24,26,101
8264,23,30,19,15,87
8265,18,29,24,26,97
8266,38,28,19,27,112
8267,25,33,29,26,113
8268,26,34,28,24,112
8269,28,20,13,26,87
8270,12,27,21,23,83
8271,19,28,17,22,86
8272,28,19,24,28,99
8273,25,24,24,18,91
8274,28,26,28,18,100
8275,25,22,24,44,115
8276,21,29,20,21,91
8277,20,33,19,36,108
8278,29,27,28,20,104
8279,36,30,18,35,119
8280,21,27,21,27,96
8281,17,29,20,31,97
8282,20,26,31,28,105
8283,21,32,24,25,102
8284,20,26,18,24,88
8285,22,24,21,25,92
8286,22,27,24,28,101
8287,21,27,21,26,95
8288,31,27,22,23,103
8289,23,25,13,22,83
8290,19,34,32,22,107
8291,20,22,33,26,101
8292,27,29,24,22,102
8293,26,30,14,23,93
8294,21,26,22,25,94
8295,19,21,30,26,96
8296,23,33,12,17,85
8297,16,28,19,18,81
8298,20,26,26,32,104
8299,24,37,22,25,108
8300,30,22,13,28,93
8301,31,20,27,24,102
8302,22,19,25,23,89
8303,21,28,24,23,96
8304,33,27,33,29,122
8305,18,24,19,20,81
8306,20,29,21,25,95
8307,33,28,23,25,109
8308,31,27,25,23,106
8309,25,27,32,27,111
8310,21,27,33,27,108
8311,17,30,18,19,84
8312,27,27,18,18,90
8313,27,27,25,19,98
8314,30,26,25,22,103
8315,21,29,21,25,96
8316,27,19,23,19,88
8317,30,28,28,19,105
8318,18,26,19,22,85
8319,24,32,20,34,110
8320,32,29,20,29,110
8321,28,25,19,16,88
8322,20,29,25,30,104
8323,27,14,27,16,84
8324,31,29,28,27,115
8325,25,23,17,29,94
8326,21,28,31,25,105
8327,17,20,27,23,87
8328,16,24,23,31,94
8329,21,24,19,22,86
8330,27,31,15,21,94
8331,28,26,21,20,95
8332,22,25,21,31,99
8333,25,28,28,16,97
8334,20,30,31,27,108
8335,20,27,22,17,86
8336,22,17,22,22,83
8337,22,25,31,24,102
8338,23,21,24,27,95
8339,18,30,29,20,97
8340,28,21,20,19,88
8341,25,26,24,17,92
8342,17,26,19,21,83
8343,28,35,22,26,111
8344,22,22,25,31,100
8345,26,22,18,24,90
8346,24,35,33,31,123
8347,25,25,23,20,93
8348,26,22,25,25,98
8349,16,32,25,21,94
8350,21,22,22,23,88
8351,35,24,13,19,91
8352,30,22,17,17,86
8353,23,26,17,27,93
8354,22,21,27,20,90
8355,25,31,31,30,117
8356,27,24,24,21,96
8357,24,34,25,25,108
8358,27,27,16,23,93
8359,17,20,24,29,90
8360,25,27,28,17,97
8361,24,25,26,13,88
8362,24,29,29,34,116
8363,26,30,25,29,110
8364,28,25,25,17,95
8365,13,27,25,20,85
8366,20,32,18,32,102
8367,22,35,23,26,106
8368,29,22,17,30,98
8369,19,22,27,26,94
8370,21,31,19,17,88
8371,25,23,24,28,100
8372,22,29,23,30,104
8373,40,29,22,23,114
8374,30,33,24,29,116
8375,29,16,24,19,88
8376,24,31,21,23,99
8377,20,24,23,22,89
8378,24,24,33,25,106
8379,28,35,24,20,107
8380,21,26,42,25,114
8381,33,27,30,33,123
8382,26,29,33,27,115
8383,25,30,31,20,106
8384,19,20,27,30,96
8385,24,26,26,28,104
8386,24,20,20,28,92
8387,19,30,28,18,95
8388,24,35,18,27,104
8389,25,24,21,18,88
8390,31,30,20,27,108
8391,30,25,28,26,109
8392,30,31,29,23,113
8393,25,30,19,20,94
8394,23,24,20,19,86
8395,25,35,26,21,107
8396,22,23,23,34,102
8397,19,21,26,23,89
8398,31,30,23,18,102
8399,17,30,22,29,98
8400,19,23,25,25,92
8401,17,21,30,26,94
8402,23,29,24,27,103
8403,26,29,21,24,100
8404,25,15,28,32,100
8405,31,31,20,21,103
8406,26,29,18,23,96
8407,20,23,24,28,95
8408,30,28,24,27,109
8409,17,24,31,31,103
8410,29,28,23,22,102
8411,20,23,29,24,96
8412,28,25,19,18,90
8413,33,41,17,33,124
8414,29,23,25,27,104
8415,31,29,19,28,107
8416,17,26,15,16,74
8417,26,29,32,21,108
8418,24,26,15,17,82
8419,13,15,24,18,70
8420,25,32,24,23,104
8421,20,28,32,22,102
8422,28,25,26,32,111
8423,26,31,25,35,117
8424,20,15,27,22,84
8425,24,27,22,23,96
8426,29,30,15,25,99
8427,17,30,22,20,89
8428,26,29,28,23,106
8429,24,28,20,30,102
8430,30,23,22,20,95
8431,15,28,24,26,93
8432,21,33,24,29,107
8433,24,23,26,25,98
8434,29,30,22,28,109
8435,24,29,23,30,106
8436,23,17,23,23,86
8437,19,31,21,29,100
8438,27,29,24,22,102
8439,20,30,26,23,99
8440,17,21,17,20,75
8441,16,24,28,16,84
8442,27,25,28,23,103
8443,24,24,19,26,93
8444,19,27,21,19,86
8445,19,35,26,27,107
8446,37,34,14,16,101
8447,22,24,23,18,87
8448,24,38,28,16,106
8449,21,37,21,20,99
8450,31,32,16,21,100
8451,33,24,16,21,94
8452,29,27,24,28,108
8453,29,22,14,29,94
8454,12,27,23,17,79
8455,19,30,23,22,94
8456,26,26,16,18,86
8457,21,29,29,22,101
8458,31,20,20,20,91
8459,29,22,18,28,97
8460,24,24,22,22,92
8461,26,28,19,26,99
8462,26,24,21,23,94
8463,22,23,24,28,97
8464,24,23,12,26,85
8465,27,28,28,27,110
8466,23,21,28,32,104
8467,31,23,25,28,107
8468,30,29,22,20,101
8469,19,30,21,20,90
8470,27,26,20,22,95
8471,20,32,21,30,103
8472,22,26,31,20,99
8473,27,26,18,20,91
8474,23,33,17,19,92
8475,29,30,28,25,112
8476,25,24,20,22,91
8477,30,36,19,26,111
8478,22,21,24,28,95
8479,24,24,25,19,92
8480,26,29,23,24,102
8481,19,32,26,20,97
8482,23,20,27,22,92
8483,21,26,31,27,105
8484,25,25,31,30,111
8485,28,26,17,33,104
8486,24,20,31,33,108
8487,28,18,20,24,90
8488,33,32,14,25,104
8489,17,22,25,28,92
8490,27,26,18,25,96
8491,19,37,28,21,105
8492,18,26,15,34,93
8493,23,28,17,22,90
8494,19,30,19,21,89
8495,29,17,27,19,92
8496,21,34,26,30,111
8497,18,25,19,32,94
8498,33,27,29,29,118
8499,22,25,21,21,89
8500,23,26,30,30,109
8501,30,17,31,28,106
8502,25,25,22,23,95
8503,22,28,26,23,99
8504,19,30,25,21,95
8505,22,37,30,24,113
8506,24,42,19,37,122
8507,29,18,20,34,101
8508,25,28,21,29,103
8509,25,38,27,23,113
8510,34,24,21,27,106
8511,27,28,24,33,112
8512,23,31,24,33,111
8513,26,25,21,22,94
8514,26,25,31,22,104
8515,25,34,19,24,102
8516,28,24,21,26,99
8517,15,25,22,23,85
8518,25,31,23,19,98
8519,28,29,21,27,105
8520,24,25,19,27,95
8521,28,28,27,30,113
8522,26,36,20,29,111
8523,26,29,28,19,102
8524,25,20,16,28,89
8525,18,29,21,21,89
8526,21,24,21,22,88
8527,30,26,21,27,104
8528,26,22,33,20,101
8529,27,29,17,19,92
8530,27,24,31,22,104
8531,14,29,26,21,90
8532,21,21,23,26,91
8533,25,28,25,35,113
8534,32,34,35,29,130
8535,26,23,18,29,96
8536,25,29,24,27,105
8537,34,27,23,26,110
8538,26,19,24,27,96
8539,23,27,18,20,88
8540,28,30,25,32,115
8541,35,30,30,19,114
8542,26,30,19,23,98
8543,26,28,26,21,101
8544,27,28,26,29,110
8545,27,26,23,22,98
8546,25,33,25,22,105
8547,26,20,16,28,90
8548,25,29,20,14,88
8549,25,33,22,18,98
8550,24,28,20,29,101
8551,17,20,33,24,94
8552,30,29,25,31,115
8553,29,26,28,22,105
8554,30,18,30,23,101
8555,25,29,18,23,95
8556,17,26,27,27,97
8557,29,17,29,31,106
8558,28,36,27,32,123
8559,21,21,25,30,97
8560,19,26,15,25,85
8561,15,28,21,26,90
8562,25,34,22,21,102
8563,23,17,20,17,77
8564,27,25,27,24,103
8565,17,27,23,28,95
8566,26,27,17,23,93
8567,25,28,19,22,94
8568,27,24,23,18,92
8569,32,35,21,24,112
8570,21,34,31,23,109
8571,23,26,24,23,96
8572,17,26,23,28,94
8573,37,29,26,18,110
8574,17,26,24,24,91
8575,25,29,27,29,110
8576,16,29,19,26,90
8577,23,34,27,22,106
8578,27,27,22,25,101
8579,23,28,25,32,108
8580,23,33,26,30,112
8581,31,31,21,27,110
8582,20,26,22,27,95
8583,29,22,21,29,101
8584,22,27,20,27,96
8585,29,28,33,35,125
8586,22,27,24,31,104
8587,27,24,27,25,103
8588,29,26,20,22,97
8589,28,27,19,25,99
8590,27,22,31,23,103
8591,19,32,19,23,93
8592,20,32,26,30,108
8593,26,32,19,30,107
8594,23,29,24,25,101
8595,25,36,23,23,107
8596,16,21,31,29,97
8597,29,22,23,20,94
8598,34,33,28,15,110
8599,36,29,34,13,112
8600,14,33,27,31,105
8601,20,21,23,19,83
8602,19,38,25,28,110
8603,18,32,21,30,101
8604,24,22,25,29,100
8605,20,31,34,23,108
8606,26,22,24,20,92
8607,24,23,28,33,108
8608,20,23,29,29,101
8609,24,33,25,27,109
8610,28,26,33,28,115
8611,23,29,29,25,106
8612,15,29,19,16,79
8613,22,20,23,20,85
8614,27,25,28,22,102
8615,22,27,31,17,97
8616,22,20,22,22,86
8617,27,19,27,18,91
8618,21,27,28,27,103
8619,19,19,21,23,82
8620,25,24,29,27,105
8621,22,26,21,21,90
8622,20,38,25,27,110
8623,21,17,20,19,77
8624,29,25,23,22,99
8625,29,33,24,21,107
8626,19,19,20,20,78
8627,20,25,25,17,87
8628,15,24,22,31,92
8629,25,27,18,20,90
8630,26,27,25,30,108
8631,19,30,23,24,96
8632,31,23,29,20,103
8633,21,22,20,28,91
8634,29,27,28,19,103
8635,29,32,31,17,109
8636,31,27,17,24,99
8637,15,26,22,24,87
8638,28,31,23,41,123
8639,19,29,23,25,96
8640,26,33,27,21,107
8641,32,20,24,20,96
8642,22,30,20,30,102
8643,20,25,23,29,97
8644,23,20,23,26,92
8645,28,29,19,21,97
8646,19,27,22,20,88
8647,25,30,31,24,110
8648,24,28,24,19,95
8649,22,26,16,27,91
8650,31,28,33,26,118
8651,23,38,24,29,114
8652,27,30,27,21,105
8653,18,24,17,20,79
8654,19,24,21,15,79
8655,21,36,26,22,105
8656,18,35,16,21,90
8657,21,25,23,18,87
8658,25,26,23,14,88
8659,27,28,27,25,107
8660,20,35,31,21,107
8661,29,31,18,22,100
8662,21,27,31,22,101
8663,27,23,26,17,93
8664,16,33,26,24,99
8665,25,30,20,27,102
8666,27,27,26,24,104
8667,21,21,23,21,86
8668,24,33,20,17,94
8669,32,36,22,22,112
8670,31,23,17,35,106
8671,30,30,28,36,124
8672,29,32,28,19,108
8673,31,28,31,25,115
8674,19,32,20,24,95
8675,21,32,30,25,108
8676,26,25,31,22,104
8677,25,20,26,19,90
8678,35,23,22,27,107
8679,30,23,18,22,93
8680,38,33,22,29,122
8681,23,26,26,23,98
8682,26,31,28,23,108
8683,20,23,18,17,78
8684,25,26,25,26,102
8685,19,28,26,23,96
8686,23,21,23,17,84
8687,17,24,27,24,92
8688,22,17,15,40,94
8689,27,31,22,24,104
8690,19,23,25,18,85
8691,27,31,31,33,122
8692,17,28,22,23,90
8693,22,24,23,23,92
8694,30,25,25,30,110
8695,28,30,28,23,109
8696,28,27,20,29,104
8697,24,25,22,23,94
8698,27,34,22,24,107
8699,28,33,32,14,107
8700,27,36,20,23,106
8701,23,28,17,23,91
8702,30,23,26,28,107
8703,26,31,24,31,112
8704,12,31,18,13,74
8705,24,24,19,24,91
8706,24,30,24,25,103
8707,23,21,22,17,83
8708,23,31,34,22,110
8709,27,18,23,26,94
8710,23,20,31,22,96
8711,29,24,21,18,92
8712,31,24,25,23,103
8713,33,22,31,21,107
8714,20,28,28,36,112
8715,21,19,35,30,105
8716,21,29,22,29,101
8717,19,22,31,31,103
8718,28,20,32,32,112
8719,29,30,23,16,98
8720,22,31,14,27,94
8721,24,23,26,21,94
8722,22,35,23,18,98
8723,22,29,24,15,90
8724,28,27,19,18,92
8725,20,35,21,25,101
8726,21,27,27,30,105
8727,27,33,27,24,111
8728,26,22,18,25,91
8729,33,28,22,30,113
8730,26,29,22,19,96
8731,25,30,20,20,95
8732,20,38,31,22,111
8733,14,23,28,24,89
8734,20,28,17,33,98
8735,29,35,26,22,112
8736,28,24,26,25,103
8737,25,28,17,32,102
8738,31,28,28,27,114
8739,22,31,23,22,98
8740,20,40,29,21,110
8741,23,26,23,24,96
8742,28,21,15,25,89
8743,33,24,18,30,105
8744,24,17,31,25,97
8745,27,26,24,21,98
8746,23,28,19,30,100
8747,23,22,20,34,99
8748,21,31,24,24,100
8749,21,30,27,26,104
8750,27,24,25,22,98
8751,19,29,30,26,104
8752,20,25,26,29,100
8753,27,30,19,22,98
8754,31,34,24,19,108
8755,18,25,16,18,77
8756,27,28,25,16,96
8757,23,26,21,19,89
8758,29,25,20,15,89
8759,27,18,29,25,99
8760,26,32,27,30,115
8761,24,33,19,20,96
8762,18,22,29,18,87
8763,19,26,19,19,83
8764,36,27,29,23,115
8765,26,24,21,24,95
8766,16,24,21,26,87
8767,26,21,24,23,94
8768,25,31,22,27,105
8769,32,30,26,36,124
8770,19,29,22,24,94
8771,21,31,22,25,99
8772,24,16,26,24,90
8773,30,29,24,24,107
8774,32,28,22,22,104
8775,17,31,28,17,93
8776,27,34,22,18,101
8777,24,23,24,36,107
8778,26,35,19,21,101
8779,30,27,20,21,98
8780,23,24,25,22,94
8781,23,34,25,28,110
8782,16,30,24,23,93
8783,24,29,23,25,101
8784,18,26,26,31,101
8785,23,49,22,20,114
8786,25,22,32,26,105
8787,28,24,27,18,97
8788,25,33,22,27,107
8789,18,22,20,20,80
8790,23,25,28,31,107
8791,18,22,27,29,96
8792,27,31,25,30,113
8793,24,30,17,22,93
8794,25,14,18,30,87
8795,27,29,25,24,105
8796,22,35,21,20,98
8797,22,31,12,23,88
8798,24,29,26,29,108
8799,21,33,31,36,121
8800,24,22,28,17,91
8801,29,21,24,25,99
8802,22,34,13,19,88
8803,23,22,29,26,100
8804,27,24,25,26,102
8805,18,22,23,22,85
8806,20,21,25,27,93
8807,17,36,16,18,87
8808,22,21,13,20,76
8809,21,28,21,31,101
8810,26,28,20,24,98
8811,20,25,15,28,88
8812,29,29,26,23,107
8813,19,29,29,23,100
8814,31,32,23,32,118
8815,25,29,24,26,104
8816,20,27,21,19,87
8817,19,32,29,23,103
8818,25,27,17,32,101
8819,18,35,21,21,95
8820,23,30,22,27,102
8821,26,25,28,24,103
8822,17,29,10,15,71
8823,33,19,19,17,88
8824,20,25,26,23,94
8825,24,35,27,19,105
8826,27,33,24,21,105
8827,22,32,29,18,101
8828,22,30,24,30,106
8829,24,33,22,29,108
8830,28,28,19,29,104
8831,19,30,26,24,99
8832,30,34,21,28,113
8833,24,23,20,15,82
8834,26,22,15,30,93
8835,15,23,25,24,87
8836,20,17,18,23,78
8837,25,21,25,30,101
8838,29,34,20,26,109
8839,28,28,25,16,97
8840,22,27,25,22,96
8841,31,24,29,19,103
8842,21,21,13,21,76
8843,29,39,19,27,114
8844,26,26,25,31,108
8845,28,28,33,25,114
8846,35,37,23,31,126
8847,24,27,22,22,95
8848,23,38,26,27,114
8849,21,28,24,26,99
8850,28,28,32,31,119
8851,33,24,29,24,110
8852,31,25,26,31,113
8853,24,31,23,22,100
8854,25,21,21,34,101
8855,21,32,26,19,98
8856,27,23,25,25,100
8857,29,24,21,18,92
8858,20,32,22,17,91
8859,20,18,30,22,90
8860,24,25,30,23,102
8861,25,38,21,24,108
8862,21,31,22,26,100
8863,30,31,16,24,101
8864,29,22,17,24,92
8865,28,28,15,20,91
8866,17,25,28,25,95
8867,23,32,30,34,119
8868,26,32,25,24,107
8869,13,24,33,35,105
8870,29,24,26,31,110
8871,31,22,25,24,102
8872,34,31,23,26,114
8873,25,22,22,26,95
8874,20,28,29,24,101
8875,20,31,23,20,94
8876,20,28,21,24,93
8877,20,28,25,21,94
8878,25,23,20,28,96
8879,34,24,26,30,114
8880,14,32,25,29,100
8881,27,24,24,20,95
8882,30,32,25,29,116
8883,21,26,20,20,87
8884,16,27,23,18,84
8885,22,26,26,25,99
8886,23,36,21,31,111
8887,22,30,21,27,100
8888,17,29,28,18,92
8889,22,24,24,27,97
8890,18,25,21,18,82
8891,24,35,23,24,106
8892,26,26,27,29,108
8893,25,26,27,22,100
8894,24,23,18,24,89
8895,23,32,16,16,87
8896,26,27,19,26,98
8897,20,27,20,29,96
8898,24,22,20,20,86
8899,38,29,15,18,100
8900,23,33,22,12,90
8901,30,29,23,26,108
8902,16,30,27,26,99
8903,28,22,29,24,103
8904,30,26,21,30,107
8905,28,30,25,26,109
8906,17,29,25,29,100
8907,19,22,21,27,89
8908,34,28,28,17,107
8909,20,30,24,27,101
8910,29,28,20,30,107
8911,23,28,23,22,96
8912,21,26,19,24,90
8913,20,33,24,24,101
8914,23,28,24,29,104
8915,24,39,19,24,106
8916,25,15,18,20,78
8917,24,25,19,24,92
8918,22,41,24,25,112
8919,28,35,24,26,113
8920,20,24,24,31,99
8921,19,34,30,18,101
8922,25,25,33,26,109
8923,23,24,22,27,96
8924,23,34,28,20,105
8925,26,33,26,31,116
8926,19,33,31,26,109
8927,21,21,23,26,91
8928,22,24,31,28,105
8929,30,23,27,36,116
8930,17,24,20,25,86
8931,24,26,27,39,116
8932,22,30,20,33,105
8933,27,25,18,25,95
8934,18,24,29,32,103
8935,26,22,28,38,114
8936,20,24,22,22,88
8937,26,24,18,20,88
8938,25,30,24,26,105
8939,26,28,23,23,100
8940,20,22,33,18,93
8941,26,24,24,27,101
8942,18,27,33,32,110
8943,21,31,21,22,95
8944,26,28,15,22,91
8945,20,32,18,20,90
8946,32,22,18,32,104
8947,19,27,20,26,92
8948,26,34,23,26,109
8949,20,30,23,30,103
8950,25,23,19,26,93
8951,18,26,22,22,88
8952,26,25,21,30,102
8953,29,29,30,20,108
8954,18,24,26,26,94
8955,27,30,25,32,114
8956,28,23,24,30,105
8957,20,32,21,21,94
8958,34,28,22,21,105
8959,28,26,33,23,110
8960,27,22,27,34,110
8961,23,28,25,21,97
8962,32,28,18,19,97
8963,32,35,15,21,103
8964,18,22,20,19,79
8965,23,28,28,30,109
8966,20,26,31,23,100
8967,24,27,20,24,95
8968,22,24,25,19,90
8969,17,41,24,23,105
8970,28,25,22,37,112
8971,25,31,19,30,105
8972,30,28,27,21,106
8973,27,22,11,24,84
8974,26,31,34,25,116
8975,21,23,27,22,93
8976,33,24,25,27,109
8977,36,34,33,20,123
8978,24,18,21,23,86
8979,20,26,17,27,90
8980,17,35,24,23,99
8981,17,27,19,27,90
8982,22,31,15,24,92
8983,22,23,24,17,86
8984,18,31,24,25,98
8985,24,26,13,30,93
8986,24,26,23,21,94
8987,20,33,20,25,98
8988,31,21,23,19,94
8989,27,37,14,35,113
8990,26,27,31,27,111
8991,26,23,29,24,102
8992,34,30,24,28,116
8993,25,27,20,30,102
8994,23,24,22,28,97
8995,18,33,17,26,94
8996,21,28,26,23,98
8997,19,24,23,15,81
8998,27,28,18,15,88
8999,23,27,21,28,99
9000,26,28,25,21,100
9001,28,21,20,21,90
9002,32,27,24,24,107
9003,25,18,26,22,91
9004,25,34,24,20,103
9005,27,28,18,28,101
9006,22,25,11,24,82
9007,27,32,22,31,112
9008,25,21,19,25,90
9009,25,26,27,20,98
9010,23,24,31,30,108
9011,15,25,30,19,89
9012,17,26,13,29,85
9013,21,19,23,27,90
9014,26,21,24,22,93
9015,20,28,17,25,90
9016,22,17,25,23,87
9017,29,33,21,16,99
9018,25,23,24,22,94
9019,19,28,26,18,91
9020,23,31,24,32,110
9021,21,22,22,25,90
9022,22,45,24,26,117
9023,30,32,29,28,119
9024,21,23,27,22,93
9025,32,25,24,29,110
9026,16,28,20,24,88
9027,28,28,28,27,111
9028,17,28,25,23,93
9029,28,27,25,23,103
9030,26,19,30,27,102
9031,28,25,29,22,104
9032,25,24,30,26,105
9033,24,17,19,18,78
9034,28,28,17,23,96
9035,17,41,23,21,102
9036,13,29,24,23,89
9037,20,36,27,24,107
9038,33,28,21,23,105
9039,31,28,27,28,114
9040,23,27,24,22,96
9041,21,24,21,14,80
9042,26,25,26,17,94
9043,27,23,25,30,105
9044,20,23,21,31,95
9045,27,32,36,27,122
9046,28,26,31,25,110
9047,31,22,26,23,102
9048,15,22,17,24,78
9049,21,28,16,25,90
9050,25,39,36,35,135
9051,22,28,21,20,91
9052,25,26,17,23,91
9053,28,25,21,19,93
9054,28,26,27,25,106
9055,15,29,37,25,106
9056,18,30,18,28,94
9057,20,24,32,25,101
9058,27,25,27,17,96
9059,23,30,28,23,104
9060,26,34,31,14,105
9061,26,28,22,20,96
9062,25,25,22,29,101
9063,22,28,25,25,100
9064,22,37,26,20,105
9065,21,31,24,22,98
9066,28,30,37,26,121
9067,21,33,20,35,109
9068,22,20,21,34,97
9069,24,35,21,23,103
9070,23,31,32,22,108
9071,29,32,23,22,106
9072,24,26,14,21,85
9073,18,26,26,26,96
9074,22,31,24,14,91
9075,20,33,29,26,108
9076,24,34,18,26,102
9077,20,25,23,23,91
9078,18,31,18,28,95
9079,22,40,18,29,109
9080,25,26,27,18,96
9081,26,24,18,28,96
9082,33,34,20,25,112
9083,17,28,19,23,87
9084,24,22,26,29,101
9085,32,30,24,23,109
9086,24,23,21,27,95
9087,18,30,20,23,91
9088,18,25,17,30,90
9089,23,19,19,19,80
9090,26,31,19,25,101
9091,28,16,25,23,92
9092,29,22,25,27,103
9093,22,22,30,23,97
9094,14,26,17,28,85
9095,28,33,23,29,113
9096,23,37,19,24,103
9097,21,30,29,20,100
9098,26,29,29,23,107
9099,22,21,25,20,88
9100,16,28,27,30,101
9101,29,29,24,23,105
9102,27,24,16,29,96
9103,31,32,21,33,117
9104,23,29,19,21,92
9105,22,26,21,33,102
9106,21,25,24,30,100
9107,25,29,22,23,99
9108,23,30,23,28,104
9109,25,27,30,25,107
9110,32,29,31,32,124
9111,27,35,27,24,113
9112,22,22,27,29,100
9113,19,20,22,19,80
9114,25,30,32,36,123
9115,27,29,24,28,108
9116,20,19,23,31,93
9117,20,29,22,28,99
9118,30,23,30,22,105
9119,22,20,24,30,96
9120,7,25,22,23,77
9121,19,36,29,25,109
9122,19,32,28,24,103
9123,16,21,24,28,89
9124,20,29,36,32,117
9125,20,26,25,30,101
9126,23,33,26,26,108
9127,19,30,18,32,99
9128,29,29,18,22,98
9129,25,27,24,29,105
9130,28,31,21,28,108
9131,21,21,32,27,101
9132,25,34,24,30,113
9133,24,21,23,21,89
9134,23,31,17,24,95
9135,23,25,26,21,95
9136,30,33,15,29,107
9137,24,35,28,22,109
9138,30,26,21,13,90
9139,23,25,26,28,102
9140,22,28,25,18,93
9141,22,18,30,26,96
9142,24,27,20,24,95
9143,25,29,19,18,91
9144,24,25,22,26,97
9145,22,23,22,27,94
9146,27,31,18,25,101
9147,29,24,18,18,89
9148,22,25,22,23,92
9149,22,26,18,20,86
9150,19,26,20,23,88
9151,26,32,27,22,107
9152,23,30,32,20,105
9153,20,26,21,25,92
9154,35,33,23,25,116
9155,26,25,23,25,99
9156,20,46,27,19,112
9157,18,22,22,30,92
9158,20,33,21,25,99
9159,27,30,27,18,102
9160,28,34,24,23,109
9161,26,25,20,18,89
9162,27,34,30,21,112
9163,22,23,21,26,92
9164,24,20,30,22,96
9165,24,24,19,27,94
9166,23,29,25,23,100
9167,32,38,26,25,121
9168,32,24,31,30,117
9169,26,21,20,26,93
9170,26,23,22,32,103
9171,21,22,18,25,86
9172,26,24,25,27,102
9173,26,22,19,26,93
9174,28,34,19,21,102
9175,32,25,27,28,112
9176,34,29,20,21,104
9177,30,31,14,24,99
9178,24,32,21,18,95
9179,27,24,24,25,100
9180,23,22,23,17,85
9181,25,30,24,22,101
9182,18,27,21,36,102
9183,24,22,26,27,99
9184,21,27,27,30,105
9185,28,18,21,15,82
9186,26,35,23,20,104
9187,30,21,20,28,99
9188,25,26,15,38,104
9189,29,20,24,18,91
9190,27,29,27,23,106
9191,27,30,19,34,110
9192,34,37,27,29,127
9193,36,26,20,23,105
9194,24,34,31,25,114
9195,26,26,16,30,98
9196,26,33,24,24,107
9197,31,30,24,31,116
9198,30,21,22,27,100
9199,27,25,13,21,86
9200,31,33,27,16,107
9201,30,25,20,27,102
9202,22,31,19,27,99
9203,22,32,29,21,104
9204,20,24,26,24,94
9205,23,35,20,20,98
9206,37,29,24,26,116
9207,22,20,18,22,82
9208,27,28,18,23,96
9209,15,31,21,20,87
9210,21,21,23,25,90
9211,30,37,25,31,123
9212,31,29,27,31,118
9213,20,26,16,16,78
9214,26,23,25,31,105
9215,18,31,16,30,95
9216,32,31,28,22,113
9217,20,28,22,21,91
9218,28,23,28,28,107
9219,27,28,26,19,100
9220,26,29,31,34,120
9221,25,29,24,37,115
9222,21,29,25,22,97
9223,29,28,33,28,118
9224,22,24,25,34,105
9225,14,29,27,23,93
9226,21,27,28,21,97
9227,12,30,22,20,84
9228,19,34,22,28,103
9229,31,31,24,21,107
9230,24,29,25,20,98
9231,27,20,25,26,98
9232,31,27,24,29,111
9233,19,31,21,25,96
9234,30,26,24,31,111
9235,34,26,23,22,105
9236,22,30,23,37,112
9237,23,31,22,27,103
9238,16,24,19,16,75
9239,20,20,29,35,104
9240,32,26,34,23,115
9241,15,27,26,31,99
9242,22,33,27,25,107
9243,19,27,26,27,99
9244,21,25,33,31,110
9245,28,19,25,28,100
9246,25,23,21,25,94
9247,21,33,23,15,92
9248,28,33,29,29,119
9249,22,26,26,24,98
9250,20,25,35,19,99
9251,22,24,22,29,97
9252,18,28,18,23,87
9253,18,33,25,26,102
9254,23,28,19,28,98
9255,19,23,23,16,81
9256,26,19,21,24,90
9257,22,29,26,29,106
9258,16,30,21,15,82
9259,27,30,16,23,96
9260,23,30,25,18,96
9261,34,30,27,27,118
9262,26,32,24,24,106
9263,23,24,14,25,86
9264,26,24,26,13,89
9265,22,31,18,31,102
9266,18,33,21,23,95
9267,19,37,19,25,100
9268,20,24,26,23,93
9269,20,33,20,20,93
9270,29,27,29,23,108
9271,26,22,22,22,92
9272,20,31,31,27,109
9273,19,32,16,25,92
9274,24,24,24,20,92
9275,19,28,18,22,87
9276,25,28,20,24,97
9277,28,30,26,27,111
9278,35,35,23,20,113
9279,32,24,27,35,118
9280,25,29,22,30,106
9281,27,37,22,29,115
9282,27,30,23,26,106
9283,31,30,16,23,100
9284,24,28,31,16,99
9285,29,24,18,32,103
9286,23,30,33,27,113
9287,26,23,18,20,87
9288,26,32,29,25,112
9289,25,24,34,19,102
9290,31,29,23,24,107
9291,26,29,24,27,106
9292,24,29,21,28,102
9293,21,25,18,28,92
9294,23,26,19,17,85
9295,22,40,26,26,114
9296,28,29,25,26,108
9297,12,24,18,20,74
9298,18,24,26,26,94
9299,18,29,29,18,94
9300,32,31,22,20,105
9301,28,20,13,29,90
9302,20,30,20,36,106
9303,18,26,35,24,103
9304,25,29,31,23,108
9305,25,24,27,19,95
9306,24,29,24,20,97
9307,26,32,24,20,102
9308,24,22,23,21,90
9309,31,27,23,20,101
9310,23,22,24,29,98
9311,28,34,31,20,113
9312,26,39,26,16,107
9313,21,20,24,24,89
9314,22,23,27,21,93
9315,27,20,28,26,101
9316,23,38,13,19,93
9317,26,19,21,24,90
9318,19,34,21,23,97
9319,25,32,14,20,91
9320,31,19,12,20,82
9321,31,25,30,31,117
9322,22,29,27,27,105
9323,22,23,25,24,94
9324,31,29,21,23,104
9325,19,26,24,28,97
9326,20,29,22,31,102
9327,23,27,27,19,96
9328,24,28,26,22,100
9329,21,30,32,23,106
9330,32,32,21,38,123
9331,19,25,20,23,87
9332,32,33,22,28,115
9333,22,25,21,21,89
9334,28,29,23,20,100
9335,30,34,23,29,116
9336,31,25,25,20,101
9337,30,38,27,24,119
9338,22,16,25,21,84
9339,25,23,29,21,98
9340,23,32,24,31,110
9341,27,33,25,31,116
9342,30,32,17,25,104
9343,21,32,23,22,98
9344,24,20,29,15,88
9345,18,39,24,20,101
9346,27,38,22,20,107
9347,25,27,26,28,106
9348,27,20,24,24,95
9349,23,29,28,29,109
9350,20,22,23,28,93
9351,33,32,20,27,112
9352,25,26,19,34,104
9353,28,33,28,26,115
9354,24,29,19,25,97
9355,22,25,22,25,94
9356,22,30,22,31,105
9357,20,22,29,34,105
9358,28,28,20,17,93
9359,20,27,24,14,85
9360,28,33,18,27,106
9361,22,23,22,20,87
9362,22,30,23,30,105
9363,13,27,22,24,86
9364,39,20,24,24,107
9365,21,40,23,18,102
9366,24,26,25,21,96
9367,20,30,20,25,95
9368,17,30,16,25,88
9369,27,31,20,21,99
9370,26,34,24,33,117
9371,19,29,18,21,87
9372,29,21,24,19,93
9373,22,14,34,12,82
9374,19,32,21,27,99
9375,17,27,22,26,92
9376,25,29,21,22,97
9377,30,27,20,17,94
9378,27,26,32,17,102
9379,26,24,32,25,107
9380,14,22,20,26,82
9381,27,22,16,32,97
9382,16,27,22,20,85
9383,32,25,19,19,95
9384,30,31,19,24,104
9385,26,35,14,19,94
9386,23,34,23,28,108
9387,15,26,25,26,92
9388,30,25,24,29,108
9389,26,26,24,25,101
9390,19,32,22,20,93
9391,29,25,14,14,82
9392,21,23,27,27,98
9393,20,31,22,24,97
9394,21,23,21,21,86
9395,29,28,24,20,101
9396,21,19,17,21,78
9397,29,28,34,22,113
9398,31,18,29,25,103
9399,21,25,24,19,89
9400,17,25,22,23,87
9401,28,26,18,24,96
9402,36,40,22,23,121
9403,30,23,22,21,96
9404,21,36,24,25,106
9405,23,25,21,25,94
9406,23,25,27,23,98
9407,31,30,23,20,104
9408,19,22,29,24,94
9409,14,43,23,23,103
9410,25,28,29,26,108
9411,21,26,28,28,103
9412,22,30,31,25,108
9413,24,22,18,24,88
9414,19,26,28,25,98
9415,26,26,23,23,98
9416,27,18,14,24,83
9417,22,26,28,30,106
9418,32,23,12,24,91
9419,20,21,27,20,88
9420,22,24,26,27,99
9421,26,26,39,22,113
9422,19,26,15,22,82
9423,19,31,35,16,101
9424,28,26,34,24,112
9425,30,25,21,22,98
9426,18,23,29,38,108
9427,30,28,30,32,120
9428,23,26,22,26,97
9429,19,37,22,19,97
9430,25,27,20,21,93
9431,24,30,20,21,95
9432,26,31,33,20,110
9433,24,24,17,29,94
9434,21,35,24,20,100
9435,21,28,24,33,106
9436,27,14,17,25,83
9437,20,25,16,27,88
9438,26,30,20,24,100
9439,34,20,16,27,97
9440,31,22,25,23,101
9441,20,28,23,21,92
9442,28,36,22,28,114
9443,27,36,19,22,104
9444,25,30,34,27,116
9445,27,23,27,24,101
9446,34,26,17,17,94
9447,27,32,26,26,111
9448,26,26,20,26,98
9449,25,27,20,21,93
9450,21,25,16,24,86
9451,25,29,20,19,93
9452,22,22,13,21,78
9453,26,21,19,20,86
9454,24,25,18,18,85
9455,26,36,21,22,105
9456,29,30,19,30,108
9457,26,29,23,21,99
9458,25,27,28,26,106
9459,29,22,14,24,89
9460,13,25,27,28,93
9461,21,30,18,24,93
9462,28,33,17,37,115
9463,31,32,22,29,114
9464,31,30,20,18,99
9465,24,30,25,25,104
9466,30,33,17,30,110
9467,32,32,22,28,114
9468,24,28,23,21,96
9469,25,21,21,30,97
9470,23,23,26,34,106
9471,26,21,26,19,92
9472,25,29,19,15,88
9473,26,21,12,32,91
9474,31,27,23,29,110
9475,23,23,21,27,94
9476,24,19,21,27,91
9477,19,32,20,25,96
9478,21,36,19,19,95
9479,28,26,28,28,110
9480,19,26,25,17,87
9481,31,32,24,22,109
9482,18,34,21,20,93
9483,23,23,23,15,84
9484,32,23,19,24,98
9485,32,46,14,26,118
9486,23,25,25,25,98
9487,28,29,18,15,90
9488,15,36,26,25,102
9489,24,38,21,21,104
9490,24,32,27,23,106
9491,25,25,17,22,89
9492,23,28,27,28,106
9493,23,29,32,22,106
9494,23,25,20,24,92
9495,23,32,22,27,104
9496,18,22,24,20,84
9497,19,21,33,21,94
9498,20,23,24,16,83
9499,32,26,25,26,109
9500,31,35,23,25,114
9501,23,21,16,22,82
9502,24,32,19,18,93
9503,27,29,26,25,107
9504,19,26,33,18,96
9505,25,32,32,21,110
9506,23,17,16,32,88
9507,19,22,34,18,93
9508,22,25,30,23,100
9509,16,23,27,20,86
9510,20,23,29,24,96
9511,27,34,26,16,103
9512,23,24,20,25,92
9513,25,25,25,22,97
9514,23,35,19,27,104
9515,22,24,22,16,84
9516,26,23,28,28,105
9517,14,29,28,28,99
9518,25,24,31,32,112
9519,22,31,19,24,96
9520,28,32,26,24,110
9521,19,23,21,27,90
9522,21,34,28,31,114
9523,25,25,19,22,91
9524,22,43,27,36,128
9525,20,27,23,21,91
9526,19,36,30,21,106
9527,20,28,15,24,87
9528,22,30,18,30,100
9529,21,27,23,15,86
9530,22,31,24,27,104
9531,26,25,26,21,98
9532,20,15,22,21,78
9533,16,25,16,32,89
9534,26,22,27,22,97
9535,25,32,28,28,113
9536,24,30,20,18,92
9537,26,31,28,27,112
9538,26,26,27,32,111
9539,18,25,20,17,80
9540,30,28,32,26,116
9541,26,29,21,20,96
9542,31,25,33,34,123
9543,30,36,30,24,120
9544,25,26,25,20,96
9545,30,21,22,23,96
9546,22,27,19,16,84
9547,25,33,35,21,114
9548,26,29,27,27,109
9549,21,27,24,41,113
9550,27,31,26,23,107
9551,26,33,27,21,107
9552,21,22,35,28,106
9553,28,29,25,17,99
9554,32,30,24,23,109
9555,30,22,22,22,96
9556,22,20,24,25,91
9557,27,26,20,23,96
9558,18,40,20,18,96
9559,21,18,18,20,77
9560,22,27,26,19,94
9561,22,26,23,26,97
9562,25,27,28,23,103
9563,18,32,25,29,104
9564,25,27,29,28,109
9565,25,31,21,26,103
9566,18,28,23,19,88
9567,21,27,22,32,102
9568,28,33,20,18,99
9569,18,38,24,25,105
9570,20,28,20,37,105
9571,16,24,20,13,73
9572,18,32,23,27,100
9573,27,32,17,27,103
9574,23,29,26,28,106
9575,29,34,25,30,118
9576,27,30,28,22,107
9577,23,25,35,22,105
9578,29,28,15,18,90
9579,28,28,29,30,115
9580,29,35,23,28,115
9581,34,27,21,22,104
9582,29,26,29,29,113
9583,19,26,23,26,94
9584,27,25,23,21,96
9585,26,26,18,16,86
9586,23,32,29,30,114
9587,31,29,23,23,106
9588,27,25,35,19,106
9589,25,21,18,21,85
9590,23,32,12,28,95
9591,20,21,17,21,79
9592,11,24,27,24,86
9593,21,24,37,21,103
9594,25,29,23,17,94
9595,18,27,25,25,95
9596,28,25,20,29,102
9597,26,31,35,22,114
9598,24,17,22,36,99
9599,30,33,24,31,118
9600,25,28,24,20,97
9601,26,25,22,29,102
9602,31,27,28,31,117
9603,22,32,26,29,109
9604,21,29,24,32,106
9605,25,31,23,25,104
9606,24,29,24,16,93
9607,17,37,26,21,101
9608,29,27,23,24,103
9609,23,27,28,24,102
9610,24,30,24,35,113
9611,31,33,25,21,110
9612,20,27,25,22,94
9613,29,24,28,20,101
9614,25,18,24,25,92
9615,19,31,24,21,95
9616,15,28,21,22,86
9617,20,27,23,22,92
9618,21,29,25,30,105
9619,29,27,22,33,111
9620,22,19,22,23,86
9621,21,21,20,18,80
9622,20,26,15,28,89
9623,22,35,19,23,99
9624,21,33,26,18,98
9625,19,23,23,25,90
9626,29,29,27,26,111
9627,20,30,30,22,102
9628,37,36,20,25,118
9629,34,26,26,26,112
9630,11,25,30,20,86
9631,26,23,23,28,100
9632,28,27,26,22,103
9633,24,23,28,23,98
9634,33,22,22,22,99
9635,20,23,21,17,81
9636,20,28,18,23,89
9637,25,32,24,20,101
9638,31,23,21,21,96
9639,19,38,36,23,116
9640,23,23,20,19,85
9641,17,25,21,16,79
9642,23,26,24,35,108
9643,30,33,27,24,114
9644,19,20,32,20,91
9645,27,25,27,24,103
9646,20,28,19,25,92
9647,17,20,19,21,77
9648,32,28,29,30,119
9649,27,31,15,20,93
9650,26,24,25,20,95
9651,31,22,24,25,102
9652,28,36,31,20,115
9653,21,32,23,18,94
9654,23,30,17,23,93
9655,29,21,23,30,103
9656,20,25,23,24,92
9657,25,28,27,34,114
9658,23,26,21,16,86
9659,28,28,26,30,112
9660,23,30,25,32,110
9661,21,23,26,23,93
9662,23,31,21,23,98
9663,16,29,21,34,100
9664,23,25,21,23,92
9665,20,19,17,17,73
9666,35,26,18,22,101
9667,21,24,22,20,87
9668,23,37,24,23,107
9669,20,22,28,19,89
9670,29,28,23,14,94
9671,22,20,24,19,85
9672,23,27,23,23,96
9673,19,30,20,20,89
9674,14,18,16,12,60
9675,24,31,23,23,101
9676,34,26,24,20,104
9677,24,26,21,18,89
9678,22,31,25,32,110
9679,20,25,29,22,96
9680,24,31,23,16,94
9681,23,25,24,30,102
9682,22,27,26,22,97
9683,26,25,28,20,99
9684,26,22,24,23,95
9685,26,30,20,19,95
9686,21,21,28,25,95
9687,26,28,26,23,103
9688,22,25,20,21,88
9689,22,28,30,21,101
9690,23,28,29,15,95
9691,22,25,27,22,96
9692,25,25,24,22,96
9693,30,21,26,25,102
9694,27,33,23,26,109
9695,19,34,23,22,98
9696,25,36,25,23,109
9697,21,27,22,28,98
9698,28,29,24,27,108
9699,28,30,28,25,111
9700,20,38,26,37,121
9701,23,30,20,21,94
9702,18,20,19,29,86
9703,23,24,23,20,90
9704,28,28,29,29,114
9705,18,22,14,30,84
9706,23,31,28,23,105
9707,24,36,19,32,111
9708,27,31,22,21,101
9709,21,29,21,28,99
9710,23,35,30,30,118
9711,23,20,18,25,86
9712,19,35,19,17,90
9713,29,23,22,30,104
9714,17,28,22,18,85
9715,28,27,17,29,101
9716,27,29,19,26,101
9717,23,30,21,16,90
9718,29,28,18,17,92
9719,19,30,19,21,89
9720,27,32,19,14,92
9721,22,26,15,29,92
9722,43,33,22,23,121
9723,28,29,23,25,105
9724,20,28,22,28,98
9725,34,24,18,26,102
9726,27,25,20,24,96
9727,30,25,26,24,105
9728,21,30,24,16,91
9729,24,22,21,17,84
9730,28,34,27,21,110
9731,19,25,34,27,105
9732,15,25,27,23,90
9733,14,27,20,28,89
9734,23,29,28,18,98
9735,33,29,27,21,110
9736,24,36,25,32,117
9737,26,26,26,27,105
9738,35,31,27,27,120
9739,23,30,22,27,102
9740,28,20,12,20,80
9741,25,22,22,25,94
9742,17,27,34,20,98
9743,32,33,22,24,111
9744,19,32,28,27,106
9745,19,26,24,28,97
9746,28,24,24,26,102
9747,24,26,17,34,101
9748,30,26,27,18,101
9749,30,32,27,26,115
9750,24,22,23,18,87
9751,26,37,22,26,111
9752,21,26,18,24,89
9753,31,26,25,21,103
9754,28,21,29,32,110
9755,18,22,23,37,100
9756,31,29,23,26,109
9757,32,20,26,26,104
9758,28,33,19,24,104
9759,26,20,19,18,83
9760,19,24,22,24,89
9761,32,23,28,31,114
9762,22,23,25,21,91
9763,17,23,21,23,84
9764,17,29,32,15,93
9765,19,28,31,29,107
9766,23,24,23,34,104
9767,22,37,27,21,107
9768,22,28,19,19,88
9769,30,28,15,12,85
9770,20,29,27,34,110
9771,26,38,23,26,113
9772,27,24,14,35,100
9773,20,28,27,21,96
9774,27,30,27,23,107
9775,30,25,27,20,102
9776,24,28,29,22,103
9777,21,25,19,24,89
9778,28,32,30,25,115
9779,22,24,21,17,84
9780,26,25,27,30,108
9781,16,20,16,22,74
9782,25,34,28,25,112
9783,25,30,24,30,109
9784,28,26,23,23,100
9785,30,34,21,18,103
9786,31,33,25,27,116
9787,26,27,30,21,104
9788,21,30,24,24,99
9789,21,25,24,29,99
9790,26,26,26,27,105
9791,20,26,26,27,99
9792,30,34,20,23,107
9793,29,23,29,18,99
9794,21,28,21,28,98
9795,19,29,24,28,100
9796,19,25,19,24,87
9797,29,25,35,31,120
9798,29,19,16,16,80
9799,24,22,21,28,95
9800,20,31,31,15,97
9801,20,26,19,26,91
9802,33,32,19,25,109
9803,23,29,33,27,112
9804,17,25,24,16,82
9805,27,21,19,27,94
9806,30,22,25,31,108
9807,27,20,17,27,91
9808,17,29,25,19,90
9809,25,31,28,26,110
9810,24,34,18,30,106
9811,24,33,21,18,96
9812,20,31,27,21,99
9813,32,25,17,23,97
9814,20,22,23,25,90
9815,30,27,26,18,101
9816,26,35,20,22,103
9817,37,22,18,22,99
9818,21,25,24,34,104
9819,27,24,23,22,96
9820,29,32,26,26,113
9821,26,28,21,29,104
9822,28,23,22,31,104
9823,25,26,25,20,96
9824,15,30,24,27,96
9825,20,23,29,24,96
9826,21,19,19,19,78
9827,16,24,14,36,90
9828,20,25,26,28,99
9829,26,27,30,17,100
9830,20,25,20,20,85
9831,27,25,22,21,95
9832,29,31,34,24,118
9833,21,23,26,23,93
9834,23,28,20,23,94
9835,25,27,23,13,88
9836,26,34,23,31,114
9837,24,12,18,31,85
9838,23,29,26,22,100
9839,28,31,23,22,104
9840,22,27,22,27,98
9841,29,32,30,13,104
9842,21,23,27,27,98
9843,23,26,20,24,93
9844,39,31,15,18,103
9845,25,36,33,28,122
9846,21,37,23,22,103
9847,23,31,31,33,118
9848,22,34,26,32,114
9849,28,23,20,23,94
9850,23,25,28,32,108
9851,24,24,25,26,99
9852,32,18,11,25,86
9853,31,23,24,10,88
9854,18,19,17,17,71
9855,20,23,25,19,87
9856,19,25,26,34,104
9857,25,29,37,32,123
9858,24,35,23,25,107
9859,31,40,37,23,131
9860,19,39,18,20,96
9861,21,28,23,33,105
9862,19,26,14,29,88
9863,23,29,15,23,90
9864,29,29,26,23,107
9865,22,30,23,23,98
9866,21,21,20,18,80
9867,32,35,19,24,110
9868,27,27,22,28,104
9869,29,30,19,22,100
9870,19,38,26,17,100
9871,29,32,19,17,97
9872,29,27,20,28,104
9873,29,26,23,25,103
9874,20,28,18,33,99
9875,18,27,26,29,100
9876,26,29,24,20,99
9877,25,33,29,29,116
9878,26,35,26,27,114
9879,29,28,20,16,93
9880,25,29,24,22,100
9881,26,25,25,26,102
9882,22,31,21,26,100
9883,30,31,21,26,108
9884,17,23,13,25,78
9885,25,29,31,28,113
9886,27,23,18,28,96
9887,21,24,22,26,93
9888,24,22,21,22,89
9889,25,26,27,26,104
9890,25,29,24,27,105
9891,26,26,17,18,87
9892,28,23,25,24,100
9893,21,32,22,18,93
9894,30,24,19,21,94
9895,34,20,17,27,98
9896,29,31,27,22,109
9897,23,36,28,26,113
9898,37,21,20,30,108
9899,33,25,25,22,105
9900,23,31,12,26,92
9901,31,23,25,27,106
9902,21,29,21,27,98
9903,17,28,23,19,87
9904,26,25,28,18,97
9905,21,31,17,18,87
9906,26,33,28,30,117
9907,28,22,24,21,95
9908,29,34,28,22,113
9909,32,26,26,20,104
9910,18,21,24,21,84
9911,26,28,21,28,103
9912,18,25,28,20,91
9913,23,24,19,18,84
9914,28,22,20,22,92
9915,30,28,28,31,117
9916,22,34,21,25,102
9917,24,37,29,22,112
9918,28,23,25,24,100
9919,24,21,21,22,88
9920,22,32,29,16,99
9921,33,30,18,36,117
9922,23,24,37,27,111
9923,26,40,25,27,118
9924,30,29,22,25,106
9925,19,28,20,25,92
9926,25,24,24,24,97
9927,24,26,30,25,105
9928,14,33,23,18,88
9929,19,30,22,30,101
9930,26,30,21,28,105
9931,30,33,21,27,111
9932,28,29,24,24,105
9933,34,25,28,31,118
9934,25,28,22,29,104
9935,26,26,24,25,101
9936,33,30,32,28,123
9937,30,25,28,21,104
9938,20,30,28,27,105
9939,24,24,21,24,93
9940,25,28,28,28,109
9941,16,35,27,15,93
9942,13,24,26,30,93
9943,27,32,24,29,112
9944,19,18,23,28,88
9945,24,27,28,28,107
9946,25,27,22,22,96
9947,33,33,24,30,120
9948,20,26,27,27,100
9949,18,27,19,24,88
9950,22,23,27,32,104
9951,26,25,20,30,101
9952,29,24,20,29,102
9953,16,28,22,20,86
9954,17,22,35,23,97
9955,16,38,27,25,106
9956,28,37,29,21,115
9957,19,20,28,32,99
9958,24,26,27,24,101
9959,24,30,27,22,103
9960,15,25,22,18,80
9961,27,32,17,27,103
9962,24,24,17,23,88
9963,24,20,30,26,100
9964,20,23,25,19,87
9965,20,24,24,27,95
9966,26,29,32,16,103
9967,16,19,21,31,87
9968,25,22,34,21,102
9969,33,23,21,16,93
9970,25,32,27,29,113
9971,19,18,25,18,80
9972,22,29,28,23,102
9973,28,33,35,24,120
9974,31,25,22,26,104
9975,28,29,25,28,110
9976,27,27,25,23,102
9977,18,22,21,18,79
9978,33,22,23,28,106
9979,16,28,27,29,100
9980,25,24,33,23,105
9981,26,21,22,22,91
9982,18,29,23,18,88
9983,22,29,27,19,97
9984,24,31,11,24,90
9985,25,20,21,32,98
9986,23,27,22,24,96
9987,32,22,25,24,103
9988,30,21,27,28,106
9989,24,25,36,28,113
9990,23,28,22,34,107
9991,25,24,17,23,89
9992,30,20,22,26,98
9993,25,23,25,23,96
9994,21,22,19,17,79
9995,31,27,25,22,105
9996,18,28,24,30,100
9997,31,20,26,29,106
9998,25,35,23,14,97
9999,25,35,25,31,116
